jbkruschack mini stroke reading drinking delicious coffee lies brother lies love	AHKru
going forward delay congratulating pregnant ppl kids functioning adults knocked gig started	AHKru
favor read teslamays blog sicknotweak conversation mental health action solution	AHKru
leo chapstick goldenglobes	AHKru
video working shit carpet play loop study	AHKru
good start good womenshealthmag	AHKru
tremendous watching texasforever blueorigin	AHKru
bbmattk nattykate check hood	AHKru
workout called wind resistance training cuz definitely workout todayyoud better shortlass	AHKru
lovely day soccer game torontofc viarail	AHKru
alma mater typo killing jump wa sharpie quick champagnepapis photo	AHKru
love rolling office find hurst parking lot sets tone	AHKru
wow provincial student loans replaced grants nl cbcnewsca mobile	AHKru
iris brilliant doc rarebird irisapfel iris love devoted flock	AHKru
cut dry knife meat stickoh office monday	AHKru
ship canada forward	AHKru
alizalicht chance bookplates mail mine	AHKru
ronburgundy day day hundreds thousands feet air	AHKru
happening madmenamc endofanera	AHKru
buenos twitter gal killing duolingo espanol language easy	AHKru
petite pants shortened petiteladyproblems	AHKru
yknow break christmas music radio pony ginuwine christmas	AHKru
eddykayla horrifying love ya	AHKru
cbcnews winter weather accidents kitchener area today safe kw	AHKru
bbmattk congratulations olds	AHKru
country people deep love frosted lipstick super highgloss notafan	AHKru
days yaaasss thankful drifit cycling fitspo	AHKru
brisk bike eveninwelcomed breeze	AHKru
car smartphone depreciates second livewhat content device mycontent security chooseblackberry	AHKru
gmail will blackberry hub stick device love hub	AHKru
thing mind match deepbench ger goworldcup sht eating grin sorrynotsorry	AHKru
gameofthrones wrote script fifaworldcup titans falling plot twists drama drama drama	AHKru
starting physical match today fellas relax lots game play italy worldcup	AHKru
givanildo vieira de souza better hulk forward plays brazil better live kid turf worldcup	AHKru
staring mighty fine fancy footwork freaking excited allin adidas worldcup	AHKru
argue fact mother dragons children	AHKru
nectar godsdeadline deadline	AHKru
books tonight theselegs happy easter frohe ostern buona pasqua tutti xo	AHKru
sashacharnin confident southern italian aunts yesterday fact	AHKru
juleshazlewood adorable aw kids	AHKru
hustle stunning save god love sport beautifulgame	AHKru
going cs week care listening haimtheband summer vibes cmonnnnn	AHKru
jared leto dynamite speech puddle familylove oscars	AHKru
man smoked face kid wcar door bent fixing boot good canuck good hitlaugh	AHKru
gold coming soo teambradjacobs	AHKru
dkny holiday today canada cheers family day	AHKru
canadas olympic team exclusive beer fridge	AHKru
norways flag bearer hellooooooooo	AHKru
zapposservice telling hour turn time order logistics magic	AHKru
courtyforrest papi lights thebachelor lmao truth	AHKru
alizalicht project free tv stream excellent site	AHKru
jared letos skincare regimen fantastic	AHKru
awesome oldspice commercial gem oldspicemoms	AHKru
basically repeat brain going movie alive	AHKru
hey dkny gal sample size lol grabs cupcake	AHKru
air france win today allowing pieces checked luggage love lots	AHKru
listening girltalk jaipaul hustle monday	AHKru
type twitter search engine order womensweardaily dalailama dkny epic	AHKru
zapposservice thx reminding year anniversary morning wait reunite wur superiorservice	AHKru
remember wise relic icq uh goodbye whatsapp hello bbm blackberry bbm	AHKru
pleasant surprise favourite mags vanityfair nhl dapper nhlers canuck uk imisshockey	AHKru
taco cat spelled backwards taco cat reddit motion alexkinsella thought enjoy lol	AHKru
mediaobsessed teslamay omg read mind herc bb	AHKru
bagsnob dkny lady beasts business hustle big fan	AHKru
thought caradelavinge walking dkny afternoon	AHKru
nyfw channel slackerradio great hear djs playing seasons fashion missedopportunity	AHKru
love blackberry app will speak dictate morgan freemans voice imagine possibilities awesome	AHKru
nattykate lady nojudgment	AHKru
htc stand combust second	AHKru
dear blackberryhub efficient efficient bb lovenotes lookaway	AHKru
ericalotman erica wearing infamous saints bracelet suspect nonna	AHKru
congratulations team brad jacobs soo boys northern ontario represent soopride brier	AHKru
wow speaks volumes cbcnews oscar pistoriuss agent cancels future races sportspr	AHKru
photo today blackberrybychoice	AHKru
aliceluong hear read	AHKru
indiehits slackerradio beast afternoon great music selections afternoon	AHKru
going finally watch twin peaks beast west wing mediaobsessed lol	AHKru
morning started return mac radio hmm foreshadowing awesome day	AHKru
mariorocchetta ditto friend	AHKru
wtech vibes harping rim wired magazine deal move	AHKru
saturday sunday homeland	AHKru
folks snow fall zoo october april	AHKru
thequote find hope darkest days focus brightest judge universe dalai lama beast quote monday	AHKru
ninagarcia sergiorossi love tassel fabulous standout chic	AHKru
afternoon remember silverchair flashback	AHKru
streaming york fashion week live comfort laptop chilly day perfection herv ger max azria	AHKru
michelle obama total beast mode love strong woman personified mominchief dnc	AHKru
night bon temps sad wait year	AHKru
elusivebalance imagine movie theatre popcorn ready office recommend froyo soft serve mmm	AHKru
mariorocchetta lance armstrong lesson grace fire humility long clean	AHKru
wake morning feeling diddy wake happened kesha	AHKru
larasutherland thought pass info fyi spice girls will closing olympic ceremonies	AHKru
hey canada thinking larger slush fund rio usa canada beat department clear won game lame	AHKru
canada strong london	AHKru
singyshih secret gotta hammer water lol	AHKru
maggieyepes teohalbert merciersara lol thought mags wouldve sooo cool nice mags	AHKru
merciersara omg smell amazing	AHKru
beast mode federer wimbledon	AHKru
austin powers good day	AHKru
camarenal july bit wait face	AHKru
germany showing amazing passing skills mad skills baby	AHKru
katrinakaye congratulations katrina beauty	AHKru
las period beast power play boys nhl	AHKru
tweet euro wonderful time year	AHKru
bbmattk admit pretty cool	AHKru
mediaobsessed watched dare	AHKru
elusivebalance high turd factor fellas lol	AHKru
maggieyepes interesting withdrawals	AHKru
nattykate great stretch suv making appearance	AHKru
nicoleinwentash rocked bun today creeped booo lol	AHKru
aliceluong yay alice girl doubt cue saltnpepa monday	AHKru
salwairiarte thx sally	AHKru
happy wednesday clip jimmy fallon kinds awesome	AHKru
lost legend today rip dick clark	AHKru
nattykate feel better nat	AHKru
salwairiarte ohhhhh learned lol	AHKru
salwairiarte thx sally xo	AHKru
trueblood june hbo	AHKru
groove armada lake shore boom	AHKru
loving bebold website tweeps check good macbook teamblackberry	AHKru
larasutherland delicious fran hiiii hang time	AHKru
angelicize lol ouch	AHKru
wow single clock changed digital baby yeah	AHKru
aliceluong start dialogue	AHKru
california dreamin andddd goodnight	AHKru
thisisfrances fran trials tribulations going morning lol napkins handy friend	AHKru
great minivacay capital good to	AHKru
great article sympatico feat melindatravis gms ceos matter biz	AHKru
littlecitymusic course spread word	AHKru
thing tina turner wig vibe rihanna hating sayin	AHKru
listening thecivilwars bad time	AHKru
np barton hollow thecivilwars checkem	AHKru
happy monday check gotye kimbra kill jkl	AHKru
poor punxsutawneyphil course weeks winter tweeps	AHKru
bbmattk blackberry launches bes cloud integrates ms office gr start week	AHKru
fosterthepeople agreed man turn purple scene slayed great film	AHKru
isragana kill thinking thing friends lol	AHKru
love cheese mouse major swag likeaboss	AHKru
great vid ces bbmanimated check	AHKru
love ces thankful to stream online	AHKru
listening calvin harris america	AHKru
aliceluong lol torontonians sweater	AHKru
kaymichl amandakru power today gnr soo soothing gnr	AHKru
bold years tweeted torch lol blackberry bebold	AHKru
great night mb haircut celebrated st birthday soo kru	AHKru
sweet sweet sweet taste success aka kick ass marks rolling enjoying holidays	AHKru
aliceluong homegirl today notice issue lol	AHKru
writer appreciate love love delirium morning	AHKru
studying better winning berryholiday	AHKru
kaymichl kill scholarly materials hilarious lot damage lb textbook lol jk	AHKru
nightcap friday night lights season perfect clear eyes full hearts lose	AHKru
meant tweet friday usual zappos ready order door hrsnow serviceloveem	AHKru
jbkruschack happy cat	AHKru
surprised boudreau caps head coach best luck hunter caps	AHKru
big push weekend kruschack haus kw contingent	AHKru
loving watching pens game corporate finance homework perfect add bylsma mo fantastic	AHKru
mariorocchetta goals hmm drink body weight coffee bc going	AHKru
mariorocchetta mar boss	AHKru
listening thesheepdogs learn burn repeat nowplaying	AHKru
sashatong fresh daisy	AHKru
mariorocchetta fun weekend hope event	AHKru
rosalynnm lookin good happy halloween	AHKru
ricob enhances monstrous disdain public transit	AHKru
time warped weezer	AHKru
hey tweeps friend chris nash film competition votescheck enjoy vote	AHKru
listening portugaltheman perfection sweet fall day epic cool	AHKru
jbkruschack going recommend good vacuum cleaning lysol wipes lol good job bro	AHKru
midterms week dance mofo	AHKru
walk wflip flops crunchy leaves october	AHKru
rip steve jobs	AHKru
snowballs eleven hello dinner studentlife	AHKru
mind blown cirque du soleil amazing see	AHKru
wonderful shwarma dinner markpgibson ice cream truck house winning	AHKru
pm spent evening international trade distribution tucked ready rest sweet sweet rest	AHKru
amandarubin guys will rebound strong buy stocks	AHKru
reserved spot oprahs lifeclass special invite friends to class	AHKru
day success rock people	AHKru
kaymichl hmm workstudylazystudy program watching movies bursary	AHKru
taylor swift bonus points books performing super bass nickiminaj speak tour	AHKru
break heart snuggle dog huffingtonpost watch dog refuses leave fallen seals casket	AHKru
dear lazy sundays love amanda	AHKru
best advice simple perfect stay distractions work hard getitdone family	AHKru
loving bbm update	AHKru
terrible match shootout hate congratulations japan valiant effort usa	AHKru
melindatravis tardy big	AHKru
jose baez al talking	AHKru
ready trueblood blow mind tonight hbo	AHKru
fun busy weekend hoping week smoothly	AHKru
wow wow wow boston vancouver canucks	AHKru
best great time south wfamily lots memories	AHKru
amandarubin soo enjoy vacay	AHKru
canada epic disappointment sault moving denmark elxn	AHKru
taylor swift mendel fail love top lost bottom	AHKru
posh becks perfect	AHKru
wowsaw hanna tonight great movie st time longtime idea nextthis girl kicks entire bourne series ass	AHKru
hockey fans playoffs tonight wbarbara walters special royal wedding	AHKru
amandarubin safe travels amanda	AHKru
ouch rim prteam therescue statwhere handlers intcmon team bb pull socks upu	AHKru
congratulations curtoneil announcement best jes	AHKru
thisisfrances amazing blood sugar shot thought mmmmmm	AHKru
annapolitoo mess lol	AHKru
musical episodes greys fail	AHKru
amandarubin thx will definitely	AHKru
rosalynnm william glass jar	AHKru
happy birthday hardest working ppl sports biz melindatravis hope good spoiled	AHKru
swingers nice sunday night so money baby jonfavreau	AHKru
jeanettejenkins melindatravis ada antonio bighave fun	AHKru
mediaobsessed dislike button	AHKru
melissacugliett atta girl melly	AHKru
thisisfrances intoxicating worst guy serious gals camannn	AHKru
what blackberry wtheir marketingbranding campaigns keeping tangible cont	AHKru
find groom lol	AHKru
mediaobsessed good luck diana rock lady	AHKru
hello leftfield win girl	AHKru
fitting weekend paper romance groove armada happy valentines weekend loves cqf ebgom	AHKru
love latest love vids blackberry perfect mix branding bb tech speak touch cool	AHKru
enjoying winklevi int piersmorgan stand piers constantly interjecting answers distracting	AHKru
spending weekend football nephew matteo ben lbs	AHKru
blackberry stay organized bb top calendar appointments personalized ringtones workpersonal calls	AHKru
loving nhl allstar skills competition	AHKru
hanging corporate magzine	AHKru
forward reading entry team good read sportsbiz	AHKru
mandydennison unfortunate thumbs downnn	AHKru
amandarubin better cash club points	AHKru
enjoying popsugar great start	AHKru
canada johansen yeah worldjuniors	AHKru
full day hockey nice season swing things wjhc seaofred nhl	AHKru
wow blackberry torch ads blowing tsn live feed nicegocanadago	AHKru
gohabsgo nice quick period good penalty kill mtl	AHKru
amandarubin employee year boygirl help texting lol	AHKru
rimstudents bit one trick pony days	AHKru
long snowfall headline	AHKru
gloria head marconi festa lol	AHKru
favourite song to kylieminogue outta fierce bhgaw lblskob av	AHKru
mediaobsessed bad admit jealous kids trick treat	AHKru
curtoneil suggestion call post office	AHKru
congratulations mayor debbie amaroso saults female mayor boys club longer	AHKru
williamryounce nice fall weekend plsive curly hair humidity friendlyenjoy urflipflops sorels	AHKru
great article melindatravis age pr crisis managment commentpr team killing sports pr biz	AHKru
mariorocchetta thx mar cupertino california good	AHKru
thoughts pavelec thrashers team	AHKru
love song love video brandon flowers young youtube	AHKru
mediaobsessed week meh	AHKru
melissacugliett curve nowcost torch inflated superior yr downupgrade	AHKru
roger federers lindt chocolate commercial best hilarious chocolate balls	AHKru
nadals forearms positively gigantic complainin usopen	AHKru
mandydennison totally prepared awesomeness literally clapped lol	AHKru
long curly hair insured polamalu	AHKru
bbmattk blackberry caught att commercial torch awesome ride cart work	AHKru
publiside lebron accomplished career yetclearly kanyewest pr book disappointing	AHKru
mediaobsessed heck ya	AHKru
melsantamaria morning melly jonah oskar hello	AHKru
mariorocchetta going kiss tonight mar	AHKru
to winter classic heinz field penguins capitals	AHKru
great causegreat read team comment pr pure class melindatravis hmcharles wesleymallette katrinakaye	AHKru
blackberry torch gonna blow att rim bb	AHKru
hair appt sat hrs hockey moms talked hrs future nhlers canada	AHKru
mandydennison socalled life simply years	AHKru
mad men true blood tonight	AHKru
canadian television swapping bodily fluids talk money	AHKru
love rim knock crabapples high horse	AHKru
curtoneil loli facebook videosi luv desree circa romeojuliet bazluhrmanera going stick boss	AHKru
amandarubin bear danke soo visit lol	AHKru
puyol smart great flamenco dancerthis announcer creeperknows puyol	AHKru
christiekung congratulations christie	AHKru
mariorocchetta wonder playing third fiddle going feel glad lbj bs	AHKru
wondering heck going worldcup	AHKru
love listening music working computer day	AHKru
players offside goal	AHKru
happy canada dayall americans free day pass canadian todaystock maple syrup canadian beefbrew canadianclubmy fav	AHKru
congratulations betawards melindatravis ballot works cable awards year row	AHKru
rosalynnm cute politico	AHKru
mariorocchetta eww feel awkwardness gross	AHKru
ovechkins acceptance speech definite highlight tonight nhlawards	AHKru
usa making bid host cup amanda attendance cup	AHKru
walsha longtime habs fan epic performance legendary goaltending halak fan best luck stlouis	AHKru
patrick kane cup clubbing spoke heart toews unnoticed	AHKru
mom laughed downed coffee suicides store tonight cuz cute evil	AHKru
pepsi promo good meausre aib pztq	AHKru
amandarubin wondering damn thing	AHKru
coffee friend kisses	AHKru
mariorocchetta going lie busted laughing visual mind od word	AHKru
mediaobsessed included lame uni friends matter fact chin	AHKru
relaxing tanning mind	AHKru
robyns tracks killer forward body talk pt peace fembot xx	AHKru
mariorocchetta mar the game flyingggggg	AHKru
double agent lol	AHKru
mediaobsessed jackie rolling grave	AHKru
totally channeled don draper today	AHKru
amandarubin help cats rubin oskar eat	AHKru
thisisfrances passthegin mediaobsessed drink drink woop woop skins	AHKru
thisisfrances stomach hurts thinking senjoy night lav lol	AHKru
kevin zegers totally doin lame mention watching gossip girll laughing	AHKru
watching movie vhs wearing vintage dylan mckay tshirt rad	AHKru
mediaobsessed shit season killed	AHKru
carmennirvana coming link wednesday k cool pce	ATMXO_
jeez sav wow amazing unbelievable	ATMXO_
hallucinogen hits spot	ATMXO_
lmao funny fucked time baby james	ATMXO_
fucking lit omfg holy shit love	ATMXO_
wow wow wow forget pack	ATMXO_
fucking track omfg	ATMXO_
excess energy wisely today unfortunate aries	ATMXO_
spirit restless prompting start project aries	ATMXO_
devikathakur legit regularly guess lesson feel bad bc pain	ATMXO_
devikathakur sync connect it box open files folders pops	ATMXO_
twelveofspades baybeehmiina lmao wonder tad bit obsessed	ATMXO_
devikathakur phone you realize phone automatically backs	ATMXO_
assume will fall place aries	ATMXO_
braedenadhd school tmrw	ATMXO_
wake feeling invincible running aries	ATMXO_
story fucking life	ATMXO_
baybeehmiina track doe	ATMXO_
huge jump grateful cheaper hey transit cheaper	ATMXO_
sairahassan tbh jealous rn	ATMXO_
love video man	ATMXO_
respecting people work fast food restaurants understand stressful yrs	ATMXO_
establishing slower rhythm today straightforward aries	ATMXO_
nah man wanna sharpay	ATMXO_
itching blast ahead jump aries	ATMXO_
happyhumpday lol ihadto behappy	ATMXO_
ellllll ohhhhhh ellllllz	ATMXO_
el em ay noooooooooooo	ATMXO_
baybeehmiina screaming phone chuck blaire sudden reply twas dawg	ATMXO_
baybeehmiina fck lmaooooooooo	ATMXO_
wth man kidding	ATMXO_
trump elected literally going wasteamericastime	ATMXO_
principal la fam	ATMXO_
cosmic energy spinning circle aries	ATMXO_
real goons fam played ytv single frigin weekend yearslol	ATMXO_
derek thistsk tsk	ATMXO_
seriously workout partner man	ATMXO_
excitement today obstacles pu aries	ATMXO_
hate writing caption snapchat cuts illiterate af	ATMXO_
watch anyones snap stories lol casually skip	ATMXO_
special today will lik aries	ATMXO_
jumpstarting project bigger challenge exp aries	ATMXO_
yall hot hanna spencer em	ATMXO_
cmon people program common sense lol	ATMXO_
ready deliver promise aries	ATMXO_
baybeehmiina nigga hang middle story froze	ATMXO_
song jasmineem baybeehmiina	ATMXO_
squeeze life aries	ATMXO_
shit floor love fucking simple baybeehmiina	ATMXO_
capable sinking deep dark places today whil aries	ATMXO_
xoxrocsi awhh working early saturday wanna bby	ATMXO_
time face ghosts jumping tackle aries	ATMXO_
markpersaud lol hope bring pants time lmao	ATMXO_
sairahassan maaztalha thought woah sai read fun	ATMXO_
itching escape today you aries	ATMXO_
searching hidden compulsion aries	ATMXO_
hey guys bad philosophy class lolll	ATMXO_
markpersaud gooooo wtf	ATMXO_
movie ball eyes	ATMXO_
round roti marry	ATMXO_
cosmic light bulbs flash illuminating mind today aries	ATMXO_
high baby roll cloud bout	ATMXO_
deejayxclusive views differ	ATMXO_
baybeehmiina kinda thoughts	ATMXO_
relationships hold great potential rememb aries	ATMXO_
baybeehmiina feel love	ATMXO_
birdtwinkle change twinkle bird	ATMXO_
you exactly love departm aries	ATMXO_
expressing feelings aries	ATMXO_
forward time today aries	ATMXO_
big space dmventures	dreamakerrealty
badbank day fundamentals	dreamakerrealty
congratulation newest recipient dream maker realty award givingback dreambig dreammaker uoft dmr	dreamakerrealty
hit stage skillsforchange	dreamakerrealty
great time ryerson dinner mehtakrishan	dreamakerrealty
level action youtubedreamresidencesyorkdaledreammaker	dreamakerrealty
excited skygridbuilds board yorkdale developmentconstruction	dreamakerrealty
coming soonby dream maker developments	dreamakerrealty
dream yorkdale condos going update youtube	dreamakerrealty
hon abikedabiri diasporanwzb interview feature story appreciated	dreamakerrealty
dream maker rogers tv youtube	dreamakerrealty
great article buzzbuzzhome left preconstruction pricesyorkdale dmd	dreamakerrealty
moneyteamgonna big fight	dreamakerrealty
great session studio talking generation wealthwe building individuals build community vertintegration	dreamakerrealty
signed engineer today famous project marilyn monroe building mississauga public launch coming yorkdale dreamteam	dreamakerrealty
housing concern fearing crash pleasant surprise	dreamakerrealty
thinkgrowriches napoleonhill quote	dreamakerrealty
movement will watch will follow will reap reward will benefit based system dmc	dreamakerrealty
excellent speech high commissioner nigeriaa privilege president nigerian businessto plaque appreciate	dreamakerrealty
toronto pass york commercial property boomneed provide units office spaces financialpost	dreamakerrealty
time change game	dreamakerrealty
thx god yeardriving yorkdale buy lv shoe tesla carbut discuss real estateyorkdale dmd	dreamakerrealty
crazy valet parking yorkdale spot hand happy yorkdale	dreamakerrealty
bnn td sees decline housing sales prices three years bad news	dreamakerrealty
love negotiation gamehe key numbers game emotional gamethere will deals slowmrk	dreamakerrealty
true example thinking long term puck will strategic movements great read vaughn dmr	dreamakerrealty
deals grey cuplink	dreamakerrealty
great article dreammaker team read apart fact love shop stay tune big news	dreamakerrealty
kevinolearytv pm est time sharktank abc	dreamakerrealty
globebusiness globemoney bank canada rate move imminent carney interesting	dreamakerrealty
andrewlafleur buyer paying example month bad	dreamakerrealty
behalf dreammaker teamwe friendsfamilyclients believing dmr award	dreamakerrealty
dreammaker appreciate clients top service mandate great call group referral referrals referral	dreamakerrealty
gold real estate hear protects inflation searching hard deals bricks gold rolex diversify	dreamakerrealty
bubble don bubble flaherty told reporters yesterday wonder media company will repeat st lol	dreamakerrealty
blessed heavy panels best session tech real estate stocks great job ufsctoronto	dreamakerrealty
great ryerson lead path launch major real estateits time industry professional courses	dreamakerrealty
interesting article expert happening wreal estate rent buy play watch tough	dreamakerrealty
reasons invest herejakaicanada rises top economic freedomus plummets	dreamakerrealty
karlynpercil time def fly	dreamakerrealty
bnntv euro zones economy heads recession	dreamakerrealty
time hype posting news canadian condos schedule riseback fourth	dreamakerrealty
man love downtown real estate sf studio king westrents days month professional bubble	dreamakerrealty
busy busy week agents consultants joining dreammaker teamcorporate video launch tonight dmrtakeover amjustsayn	dreamakerrealty
shout wife cake bday partymuch love great start years	dreamakerrealty
creflodollar walk expectation watch dreams reality	dreamakerrealty
financialpost toronto condo bubble fears overblown stick fundamentals	dreamakerrealty
hole sponsored dreammakers smash hole	dreamakerrealty
learn real estate market learn unique real estate opportunities win free week cruise msg event	dreamakerrealty
love gamemeet investor pulls classthen bentleyno time rest nyc movements	dreamakerrealty
quote day wealthy people borrow bankso upput min lolol	dreamakerrealty
best feeling fatherhappy fathers day fathers blessing	dreamakerrealty
excited blessed beauty ashes annual holy ghost service lay foundation god	dreamakerrealty
year battledream maker realty owns turning dreams owning realitythanks legal team hard work	dreamakerrealty
dreammakers knocking real estate game beltlolgame joke	dreamakerrealty
high return long term creating millionaires decade dreamfund	dreamakerrealty
early morning tour future panam sitelargest urban development downtown analyze invest investors win	dreamakerrealty
market expensive bed wash brand closing percent rents roughly hmmmmmmm	dreamakerrealty
great time ottawareception house senatehistory making	dreamakerrealty
interesting financial movie chasing madoff holy felt mob movie lol	dreamakerrealty
question crowd isaaaaac market gonna crash answer sir tenants payn mortgagelol	dreamakerrealty
buyers location equals	dreamakerrealty
investors sitting excited good projects dream fund nextcan yorkspring shopping	dreamakerrealty
ooooo properties located yorkville area floridacollier town sense guess depression skipped lol gzzz	dreamakerrealty
wow shockedtoronto thought highest prices media talks haha	dreamakerrealty
buzzbuzzhome amount construction toronto liberty village control agree love sales	dreamakerrealty
bildgta city north america amount growth toronto losangeles	dreamakerrealty
game annual black voices conf york universityspeech dream broke barriersthen hr financial literacy session	dreamakerrealty
business continueheadin york radio interview york conference weekdmrdfh city wide tour	dreamakerrealty
jakai lololit would	dreamakerrealty
joelosteen people hurting love encouragement god bless	dreamakerrealty
landwe doingresidentialand commercial parking projectprime downtown locationthis buying gold stock pple	dreamakerrealty
ready head yorkville project rest dream maker teamto pick units	dreamakerrealty
emails calls started yorkville accessbuy bf vip brokers buy finished product realestate	dreamakerrealty
room packing real estate panellooks people wanna making money amazing game called real estate lol	dreamakerrealty
walkerlaw great workwhere going bemy brother love	dreamakerrealty
interesting article torontolife surprised thocost living will higher yrs	dreamakerrealty
fairmont royal yorknice panel business ownersceos speaking growth global opportunities sick	dreamakerrealty
savers screwed percent gic economist monetary policy expert carleton university ottawa	dreamakerrealty
great event bildgta	dreamakerrealty
canadian housing market balloon bubblebmo truth loli love bank play market	dreamakerrealty
good pres craig sr vp chief economist td bankended sayn gta will slow yrs lead canada yrs great	dreamakerrealty
uploaded youtube video jade developments st project wdream team partner	dreamakerrealty
york real estate values increase recession naw bloomberg valuetoronto york	dreamakerrealty
confusion equals opportunitybanks fromprices highmarket hotdebt rate hightograb yr yr lolol	dreamakerrealty
nighterworking st dream project launch dreammakerdreamfund bliz radiotvnews paper starting tomorrow	dreamakerrealty
globe mail toronto hottest marketstick dream indicators protected correction	dreamakerrealty
happy yearthank god will god bless	dreamakerrealty
surprised storydont chase hype price location deposit simple hard find	dreamakerrealty
uploaded youtube video dream makers christmasappreciation party	dreamakerrealty
condos lowest types torontoreally clarity people buying condos homes eh	dreamakerrealty
busy dayworking high demand projects yorkville dreammakers xmas jam	dreamakerrealty
example going canada money coming canadalong term growthin	dreamakerrealty
luxury condo pad mississaugapenthouse feelgreat viewone best units	dreamakerrealty
finished presenting award aroni awards galawe support community clip ctv	dreamakerrealty
toronto prices high read articleand super prime sf growth	dreamakerrealty
day deals worth units signed uoft private president dinner going hard till xmas	dreamakerrealty
ready speak redeemed christian church god btown generational wealththen chinese canadian entrepreneurs event	dreamakerrealty
mediahuddle tmh dreamakerrealty sponsoring followme free eventcant wait event	dreamakerrealty
stay tune brokerage sitethat will case dream teamyou dream makerwithout dream team	dreamakerrealty
miaoo feeln good ready toronto board trade business excellence awards going hard till xmas	dreamakerrealty
leaders tomorrow joins annual national black business professional convention nbbpc expo gonna good evening	dreamakerrealty
sflakeshore closing yearswhat wantthis calling bubblelol gonna buying	dreamakerrealty
big chris finding amazing bedrooms lakeshore wparking lake view closing yrs percent dreamfund baby	dreamakerrealty
wowdude dunked onthe dreamteamoshawa powerscant wait season	dreamakerrealty
iphoneswe investmentscondosi love passion	dreamakerrealty
nba nbl incanada stand oshawa powers	dreamakerrealty
golf game donechilling joe carter hockey baseball players partygolf bizwhat	dreamakerrealty
studiostarting sq feet yorkville will nycbut knew fastjoke vip prices lol	dreamakerrealty
lifestyle thisno turning team big news stories tridelwater frontturn dfh	dreamakerrealty
otissmooth ride long week	dreamakerrealty
week action weekstay tune rrsp fund launch	dreamakerrealty
dreamfund teamgets access vip locationschilling beach villas start	dreamakerrealty
broker fund managerone the financial street pull percent fund managerso wealth creation	dreamakerrealty
send resume min years salesmanagement experiencedream makerdream fundlooking	dreamakerrealty
dream makera win money investments real estate purchasesimple game	dreamakerrealty
stay tune info potential st dream maker development project acresdream bigplay bigsimple	dreamakerrealty
word streets korean dreamfund selling fast good job broker partners dreamteam to packages deals	dreamakerrealty
globe mail article president dream fund	dreamakerrealty
big dayboard meeting advisory members dream fund launch uofttyp	dreamakerrealty
great day today connections consultants helping push dream maker gta gta	dreamakerrealty
awudrick asked honest answer gov capital markets bbd assisted	MacSweeneyG
gavmac blame ottawacitizen	MacSweeneyG
bode republicor rest matter	MacSweeneyG
bethe opportunity open long fulfill citizenship democratic requirements	MacSweeneyG
nationallibera redpeter conhome course libdems benefit good fortune	MacSweeneyG
ldobsonhughes robfordmancs ages mps elected died long served house	MacSweeneyG
graciestyle issue notion history doubt west traditionally viewed	MacSweeneyG
graciestyle win country region defend interests	MacSweeneyG
markdjarvis great finally meet youhope chance love talk depth laurapayton cmaconthehill	MacSweeneyG
stefcoinc emmmacfarlane laurentianu granted lectures laden drop matter degrees	MacSweeneyG
dougsaunders thedailybeast hess vallentyne flavour	MacSweeneyG
interesting yr mon passed bed yr jumping bed singin house top	MacSweeneyG
lake poopo bolivias ndlargest lake dries	MacSweeneyG
msbriggshdsb torontostar globeandmail putting positions dislike heart lib democracy called tolerance	MacSweeneyG
perreaux father inlaw conditioned sweet mix follow	MacSweeneyG
tashakheiriddin lawmcgill explain christyclarkbc constitutional legit	MacSweeneyG
rachellemac morning doubt prob def pm position	MacSweeneyG
laurapayton glad hear	MacSweeneyG
awudrick cbcthisisthat johnny asked odds going sh lesson	MacSweeneyG
squidpope timhudak upside lpontario prob deregulate rest bought populist tide turns	MacSweeneyG
mlinstitute tashakheiriddin vacuous abolishing senate politically impossible better debate real possibilities	MacSweeneyG
joshuahind terryglavin markbourrie mattgurney rowancaister art assumes group capable negotiatingdealing isis	MacSweeneyG
mattgurney rowancaister terryglavin joshuahind rightly afghanistan state harboured	MacSweeneyG
illinoisrider intend writing professional piece affect peer reviewed journal	MacSweeneyG
illinoisrider kind claimed chemist publish wait forgot publishing sucks	MacSweeneyG
illinoisrider stefcoinc making claims chemistry scientist call failure	MacSweeneyG
call phd failure follow supplement company carlsonlabs	MacSweeneyG
realdarrencohen ap big big	MacSweeneyG
quality quantity suppose	MacSweeneyG
real life fantasy	MacSweeneyG
thought conservative century	MacSweeneyG
realize economic argument making moral argument ohsheri mattgurney russilwvong fullcomment	MacSweeneyG
mattgurney ohsheri russilwvong fullcomment boots ground kurds collateral damage	MacSweeneyG
vote elxn hope enjoyed ride exit polling booth	MacSweeneyG
nathanf mdentandt harpers machiavellian ways suddenly faced hobbesian reckoning thestateofnature	MacSweeneyG
mdentandt althiaraj huffpostcanada week desperation abound begun final countdown sexdrugs	MacSweeneyG
cselley faulty analogy asinine bc healthsafety bc economics	MacSweeneyG
nspector dgardner pols role play game responsibly	MacSweeneyG
bonkwazi robsilver collective rights	MacSweeneyG
arroganthair better standards education	MacSweeneyG
markdjarvis sarcasm full agreement deceit deceit public figure justinling	MacSweeneyG
will tension family today gavmac paoconnell cmaconthehill stuartinthecage rugbyworldcup irevcan	MacSweeneyG
fantastic analysis breaking separation church state moalhakim wheresmonica realdarrencohen	MacSweeneyG
jandrewpotter comfortable blue tent ease red	MacSweeneyG
sad statepolitics requires constitutional law opposed conventionbut convention	MacSweeneyG
bristoldriver supply evidence demographic claim glenmcgregor	MacSweeneyG
inklesspw michael buffers ad readyto rumble	MacSweeneyG
definitely worth read	MacSweeneyG
agmacdougall ottawacitizen scottreid agree	MacSweeneyG
mdentandt longer paper	MacSweeneyG
inklesspw answer question finance minister safe riding	MacSweeneyG
robsilver ode grecian urn	MacSweeneyG
inklesspw davidakin emmmacfarlane stphnmaher pdmcleod mikepalcanada broadbent manningcentre pearsoncentre interest	MacSweeneyG
rachellemac bucket list	MacSweeneyG
realdarrencohen three race	MacSweeneyG
cbcthehouse chrishallcbc excellent choice congratulations	MacSweeneyG
davidakin grant difference policy mistaken policy thomasmulcair kyoto	MacSweeneyG
laurapayton cbcpolitics good luck	MacSweeneyG
markdjarvis pmlagasse find sample size highly suspect surely success discipline dependent	MacSweeneyG
jandrewpotter rebel transaction	MacSweeneyG
torontogil votejoanmouland liberalparty justintrudeau constitutionally viable scc senate reference	MacSweeneyG
fifacom boss decided call quits dinner	MacSweeneyG
experience fleeting harper ahead october keithboag shoe fill fleeing sinking ship	MacSweeneyG
leftardhockyguy actiongeologist analysi	MacSweeneyG
actiongeologist analysis poor	MacSweeneyG
dleebosh kind sex life	MacSweeneyG
laurapayton happy enjoying	MacSweeneyG
sladurantaye davidakin bothers reading comments feed trolls bridge ignore	MacSweeneyG
mike duffys expenses questioned senate start	MacSweeneyG
brynnbeard amazing members cupe drastically views inklesspw	MacSweeneyG
thingsliamneesoncanstab pint tongue paddys day	MacSweeneyG
bc things grow veterans will verify lost limbs years	MacSweeneyG
mrsinisterlefty laurapayton lamented	MacSweeneyG
laurapayton mrsinisterlefty jim stanford folks cnd policy alternatives tv regularly network mind	MacSweeneyG
cbctoronto mybeerstore torontostar stefcoinc cmaconthehill michaelfaz buy beer beerstoreboycott	MacSweeneyG
fantastic facebook photo grocery store clerk walking senior customer viral	MacSweeneyG
chastonb fareestweetable ctvmercedes oxymoron democracy voting freedom free vote	MacSweeneyG
harper created petro dollar loonie	MacSweeneyG
shauntanakays position standing representation	MacSweeneyG
realdarrencohen rest american friends happy thanksgiving	MacSweeneyG
lesliecbc rosiebarton pnpcbc jamesbezan pmharper winston churchill friend mine sir winston churchill	MacSweeneyG
interesting position ethicsblogger credence socrates disciples	MacSweeneyG
ted rogers leadership cmaconthehill laurapayton aradwanski acoyne chantalhbert bruceanderson ethicsblogger	MacSweeneyG
cmaconthehill pair waterproof rockports	MacSweeneyG
laurapayton davidakin honrobnicholson wearing boots iraq combat sandals	MacSweeneyG
cmaconthehill laurapayton rachelle moulin rouge	MacSweeneyG
cardionews interest pivotalthr announces patent omega medicalfood vascazen obesity diabetes cardiovascular	MacSweeneyG
medicalnews interest pivotalthr announces patent omega medicalfood vascazen obesity diabetes cardiovascular	MacSweeneyG
things proposed fair elections	MacSweeneyG
stefcoinc release profile image	MacSweeneyG
check esl esea csgo pro league stream win csgo pro gear	MattSkiing
best zep song	MattSkiing
count play cowbell	MattSkiing
sauga snapchat story	MattSkiing
lol year twitter account tweets	MattSkiing
parents study hard time hit books	MattSkiing
nickb good luck man ib forgot form lol	MattSkiing
sunshinevillage time tips slackcountry safety beginner	MattSkiing
thinking going linkin park cancelled rest tour	MattSkiing
cs opening chroma cases giveaway youtube	MattSkiing
youtubeanderzel knife draw	MattSkiing
discover great free apps rewarded gift cards freemyapps	MattSkiing
youtubeanderzel skin contest	MattSkiing
thestartrpack mom starter pack true	MattSkiing
guy discovery channel suit eaten anaconda survive crazy	MattSkiing
youtubeanderzel anderz enter contest man	MattSkiing
ugh full base redesign clash clans shit internet crashing bellsuks	MattSkiing
blocked ads trackers adblock adblockplus	MattSkiing
win gtx oc watercooled gaming pc windocblock giveaway youtube	MattSkiing
thought minecraft fall success going play bebopvox	MattSkiing
android emoji set cool	MattSkiing
mcpe play store	MattSkiing
hand final exam	MattSkiing
teamrussia worldcup supporting	MattSkiing
finally updated header	MattSkiing
whoops realized tweeted samething days row	MattSkiing
sierratheresa worst song	MattSkiing
happy star wars day fourthforce	MattSkiing
man love skyrim basically	MattSkiing
bebopvox collection vintage games	MattSkiing
raptorscf kind operating social media accounts	MattSkiing
sickest iphone case honestly buy iphone case	MattSkiing
talking making hotzaga bull wayyyy time january	MattSkiing
wtf called fire drill	MattSkiing
merry christmas eve eve	MattSkiing
ohmzapp atta boy beauty wheelingprobs	MattSkiing
djing couch plugdj playing rush red barchetta	MattSkiing
lol mall today	MattSkiing
ford model drive throwbackthursday	MattSkiing
lol watching ripoff sharknado called stonedado lol bad	MattSkiing
dangit missed bruce springsteen livestream youtube rock rio thing sick	MattSkiing
amacri lol mockup futuristic year exist licence	MattSkiing
lazy kind saturday	MattSkiing
followers live canada kazakhstan create map	MattSkiing
sierratheresa nope will scared phone	MattSkiing
gwtallent guys live detriot hamilton wait	MattSkiing
love playing walls pvp	MattSkiing
ohmzapp nice skiing foot half fresh pow ride	MattSkiing
mentionsomeoneyourethankfulfor family friendsjesusthomas edison	MattSkiing
days skiing blessed	MattSkiing
lol obsidian coffin prank	MattSkiing
leafs smoking habs	MattSkiing
boo ya snow day	MattSkiing
ohmzapp dang lucky	MattSkiing
lol dad rite	MattSkiing
park hit nice xl step fun	MattSkiing
min walk wake	MattSkiing
follower jks random comany	MattSkiing
watching cnn newsroom bell fibe tv cnnhd cnnnewsroom	MattSkiing
braveselric lucky color	MattSkiing
soo fun nite	MattSkiing
wifi skecthy cantwaitforbell	MattSkiing
praying newtown terrible tradegy	MattSkiing
kinda sucks civies month	MattSkiing
lol cloud storage minecraft	MattSkiing
thatarabdev sign free apple	MattSkiing
buy saga tank top bucks	MattSkiing
ohmzapp rember time	MattSkiing
yeeeeessss grey cup awesome	MattSkiing
yaaa star wars	MattSkiing
minecraft scared zombies skeletons spiders	MattSkiing
reason love wearing winter jacket thatsjustme	MattSkiing
davidmallozzi average lol	MattSkiing
ohmzapp austin today	MattSkiing
holy crap insane	MattSkiing
people obsessed thier imperfections geez	MattSkiing
excited today bisnuessworld	MattSkiing
lol play pocket planes tweet	MattSkiing
minecraft wiki cool	MattSkiing
text redcross ten dollar dontation helpsandy	MattSkiing
striploins blood test omy	MattSkiing
going lifetime tommorow	MattSkiing
full service dressing rooms	MattSkiing
bet time machine invented screw space time continuom fast	MattSkiing
slowpoketweets windows lol windows hahahah	MattSkiing
imichalicka tv slows morning twitter	MattSkiing
early math teachers late	MattSkiing
lol petes big hd tvs	MattSkiing
mmmmm quiznos prime rib best preconcert meal	MattSkiing
omg aerosmith song	MattSkiing
modern family bestshow sofunny	MattSkiing
bus ride fun	MattSkiing
navigatorc flying quebec thunder bay pocket planes mac	MattSkiing
springsteen revised ga lottery procedure upcoming striploins	MattSkiing
funny bitbook post pocket planes mac	MattSkiing
wings stlouis sogood	MattSkiing
reasonsiquitfacebook twitter better	MattSkiing
cold wet ride school	MattSkiing
days will forgotten	MattSkiing
laurenxo lol love hikes	MattSkiing
random pig fun day	MattSkiing
ughh throat hurts	MattSkiing
big zipline ft	MattSkiing
laurenxo omg emoji tweets	MattSkiing
ohmzapp music class day sick pass periods	MattSkiing
argg backpac locked	MattSkiing
guy bat mobile	MattSkiing
finding lot nerd bullets street	MattSkiing
yess pointy sticks grips	MattSkiing
woos snake change tennis tryout thanksteachers	MattSkiing
good thing pants huge pockets	MattSkiing
tweets over againy	MattSkiing
day great diffrent	MattSkiing
gonna awesome weekend	MattSkiing
subway cookie lol	MattSkiing
hockeylife going orientation tommorow	MattSkiing
oddfuturetime wait iphone guna dope	MattSkiing
hate forget things easily	MattSkiing
phone acting messed	MattSkiing
sierratheresa mine tomorrow	MattSkiing
phone better wifi	MattSkiing
daviddevids work cuz htc	MattSkiing
pound hot dog defintly	MattSkiing
xgames perfect day flying high ready xgames yyyyyeeeeeeaaaa	MattSkiing
xgames bobburnquist gnarly fall yesterdays big air practice xgames nooooo bob	MattSkiing
eww play jbiebs	MattSkiing
omgfacts cooties exist tiny wingless parasitic lice live warmblooded animals knew	MattSkiing
omgfacts english worlds largest cereal consumers mee	MattSkiing
wonder long twitter will	MattSkiing
mattskiin matt going crazy	MattSkiing
hate waking eye	MattSkiing
whooa soo hot	MattSkiing
lol clogging timelines	MattSkiing
playing ping pong	MattSkiing
time playing tennis	MattSkiing
playing beer pong beer	MattSkiing
phetunning ohmzapp bring beard	MattSkiing
lawl vimanala marking skills	MattSkiing
lool poureed thunder recess	MattSkiing
somethings better left	MattSkiing
weelll gotta ready	MattSkiing
mountian equipment coop downtown foot climbing wall	MattSkiing
guess evryone drama	MattSkiing
nickalis lidstrom retiring great player hall fame	MattSkiing
paintball warfare epic paintball battle youtube awesome	MattSkiing
inappropriateweddingsongs fire flames	MattSkiing
hope rain tonite	MattSkiing
shawdow day awesome anthonysoccer omg	MattSkiing
blbpt rom years jail	MattSkiing
replacemovietitleswithbacon superbacon lol awesome	MattSkiing
vimanala doitsu eruption	MattSkiing
yaay jersey won	MattSkiing
official zukeeper bisnuess going	MattSkiing
guna hot todat	MattSkiing
iwish internet full spam	MattSkiing
yaa short week	MattSkiing
the day friends playing bug ball	MattSkiing
schoolmemories baby kate	MattSkiing
block tweets retweets	MattSkiing
yeeaaahh granny voted agt	MattSkiing
wifi faded texted tweet pressed send	MattSkiing
laurenxo samme row	MattSkiing
oddfuturetime def leppard rick allen	MattSkiing
ohmzapp aint featuring	MattSkiing
oddfuturetime suit black undershirt purple tie purplegrey	MattSkiing
cnnbrk reports maurice sendak author wild things dies age nooooooo	MattSkiing
dads big leauge chew	MattSkiing
going costco lunch	MattSkiing
ma phone pretty good camera	MattSkiing
butterfly house smh	MattSkiing
sierratheresa lolled hole time	MattSkiing
rand os iwasbored	MattSkiing
takes long walk	MattSkiing
omgidothistoo exactly care yolo legit	MattSkiing
hope obsess weeks finals haha studentlife	Nounnno
tweet bismillah firsttweetforeverything	Nounnno
happy accept whyryersonryersonu offer	RowanMMolloy
rhettandlink rhett pants seriously link	RowanMMolloy
youth dates tho that dates pls	RowanMMolloy
waiting youth kiss setitoff	RowanMMolloy
leave blue neighbourhood knew loving hurt good	RowanMMolloy
tronnorfravan thinking troyeinto will march troyetoshow	RowanMMolloy
troyestripod troyesivan lol	RowanMMolloy
troyesivan killing game wait feels amazing	RowanMMolloy
hey troyesivan will	RowanMMolloy
bethanymarie vaintroyster troyesivan hold tickets	RowanMMolloy
hey troyesivan loved video youthvideo	RowanMMolloy
kiss devobrown troyesivan continue best radio station	RowanMMolloy
great youthvideo troyesivan	RowanMMolloy
holyshitsivan kiss tomorrow time	RowanMMolloy
troyesivan thisislany week gonna best night	RowanMMolloy
ashleymardell cut hair year ago today step shaving piece	RowanMMolloy
troyesivan video shazam follow troye	RowanMMolloy
cruiseclass testing testing thing	RowanMMolloy
hey troye daysofblueneighbourhood	RowanMMolloy
troyesivan excited mosh february troye boy	RowanMMolloy
kind feel noodle nanowordsprints help	RowanMMolloy
stopping tomorrow nanowrimo	RowanMMolloy
troye sivan blue neighbourhood tour danforth music hall february pm est ticketmasterca	RowanMMolloy
written today aiming nanowrimo	RowanMMolloy
currently lowest goal today highest nanowrimo	RowanMMolloy
mon est avec paris prayforparis	RowanMMolloy
writing today days going usual nanowrimo	RowanMMolloy
nanowordsprints novel sort changed nanowrimo	RowanMMolloy
hankgreen happy birthday year fan	RowanMMolloy
writing coming easily will hit tomorrow looming head nanowrimo	RowanMMolloy
nanowordsprints minutes aiming hit day nanowrimo	RowanMMolloy
nanowordsprints total making goal today homework time sprinting nanowrimo	RowanMMolloy
amymelissa the teams worldseries	RowanMMolloy
watch baseball cometogether thebig	RowanMMolloy
nanowrimo years bad	RowanMMolloy
mutantcanuck super excited universe wrote medieval loved	RowanMMolloy
rareity planner character development chapter breakdowns landscape nanoprep	RowanMMolloy
remember nanowrimo participants site resets monday ready season kick nanoprep	RowanMMolloy
erinshappy nanowrimo written adorable coffee shops corners school course bedroom nanoprep	RowanMMolloy
inspectrcaracal nanowrimo ninjas ninjas nanoninjas nanoprep	RowanMMolloy
point read short books middle ages nanoprep	RowanMMolloy
amyrohozen mine nanoprep	RowanMMolloy
therealdominia changed planner nanoprep	RowanMMolloy
nanowrimo totally planner plot graphs will live nanoprep	RowanMMolloy
sundays nanoprep work location time flesh lands	RowanMMolloy
tweet will shortest piece write season writing novel nanowrimo nanoprep	RowanMMolloy
standing place gathering coreyvidal nostalgia	RowanMMolloy
throwback robot destroying gtr central omgrobots gtrc	RowanMMolloy
tbt love met rhettandlink	RowanMMolloy
tbt fantastic photo fun fact standing table	RowanMMolloy
apprenticeeh cheesusgirl timhortons candy cane hot chocolate literally kryptonite	RowanMMolloy
toronto dundas square eaton centre occasional corradocoia	RowanMMolloy
crazyfanny hankgreen feliciaday	RowanMMolloy
loving joshsundquist johngreens pants hosting livestream	RowanMMolloy
amount school work i video year	RowanMMolloy
thenicolec thewritelist mc careless simplicity	RowanMMolloy
feels incredibly strange won nanowrimo help family	RowanMMolloy
stephragogna nomination anatrippy rattatattnat join revolution	RowanMMolloy
favourite photo favourite frame	RowanMMolloy
tired half hour nanowrimo	RowanMMolloy
starting climax novel will fall flatmaybe add exciting chapters nanowrimo	RowanMMolloy
making peppermint hot chocolate stick winter	RowanMMolloy
lovelockeprince charles sweet second going win going fill	RowanMMolloy
sigh filler scene filler scene start climax nanowrimoproblems amwriting	RowanMMolloy
caitlinbell movie watching	RowanMMolloy
johngreen swusug hankgreen realkgreen great band	RowanMMolloy
laptop problems today nanowrimoproblems	RowanMMolloy
tmburnstad horribly year ended pulling careful week	RowanMMolloy
hit high write today nanowrimo	RowanMMolloy
written today kcountdown	RowanMMolloy
judithheaney nanowordsprints brave strength courage heroic	RowanMMolloy
today finishing tomorrow nanowrimo	RowanMMolloy
barely going to today cheatday nanowrimo	RowanMMolloy
currently hour nanowrimo amwriting	RowanMMolloy
kristinahorner hit pretty pumped	RowanMMolloy
nlibrisveritas google assassins creed cosplay outfits	RowanMMolloy
nanogeekette cantrelljason halloween candy sale today worth leaving house	RowanMMolloy
nanowordsprints interrupted halfway	RowanMMolloy
amwritersclub hopefully saturday	RowanMMolloy
celiamcmahon whoo hoo good luck	RowanMMolloy
nanowrimo suggested exciting	RowanMMolloy
rhettandlink november writers earth write book month worlds caffeine supplies low	RowanMMolloy
guess preordered charlestrippy posterhint waves	RowanMMolloy
nanowrimo explain friends teachers colleges tired stressed nanoprep	RowanMMolloy
bored bus hand moving	RowanMMolloy
forgot pic sarad yesterday bufferfestival amazingweekend cbcbufferfestival	RowanMMolloy
happened bufferfestival rhettandlink wewantlinkback	RowanMMolloy
overtime win goleafsgo	RowanMMolloy
irlwishy good luck fun follow nanowordsprints sprinting will honestly save life	RowanMMolloy
coffee better job today tests paper school	RowanMMolloy
elenalinville writing characters	RowanMMolloy
whynano find community learners crazy	RowanMMolloy
mazerunnermovie terrifying ton fun	RowanMMolloy
cinnamon pancakes breakfast	RowanMMolloy
picked buffer seats excited charlestrippy	RowanMMolloy
foot times mackavaldez whitegirls	RowanMMolloy
colangelodiana sarad sawyerhartman will toronto october	RowanMMolloy
listening coreyvidal talk anxiety live vlog feel personally	RowanMMolloy
fao schwartz toy store nyc	RowanMMolloy
nanowordsprints total goal	RowanMMolloy
going minutes charlestrippy tomorrow excited	RowanMMolloy
camp nanowrimo year nanowordsprints great write	RowanMMolloy
yes lakings gokingsgo	RowanMMolloy
game lakings stanleycupfinal gokingsgo	RowanMMolloy
game interesting nyrangers habs becauseitsthecup	RowanMMolloy
st period habs habsvsrangers becauseitsthecup	RowanMMolloy
nice goal lakings	RowanMMolloy
nanowordsprints distractions stephanie lying	RowanMMolloy
pollypissypants seraheshoes alright allonsy	RowanMMolloy
nanowordsprints novel decided second load working amwriting	RowanMMolloy
nanogeekette going stay late write	RowanMMolloy
goal life nanowordsprints frinightwrites sprint leader	RowanMMolloy
spending afternoon nanowordsprints amwriting zombies	RowanMMolloy
bookshelf cleaning time	RowanMMolloy
karenkavett horridlyunfunny video collab realized wanted nerdyandkavett	RowanMMolloy
decided coreyvidal talked lot switchfoot best decision apprenticeeh	RowanMMolloy
frinightwrites major character development writeclub	RowanMMolloy
write male perspective female question	RowanMMolloy
partnersformh guess going break	RowanMMolloy
worries written assignments compare	RowanMMolloy
fantastic time question life choices	RowanMMolloy
white nice twitter time update design	RowanMMolloy
rhettandlink raises hand rooting halftime superbowl	RowanMMolloy
guess fighting goleafsgo	RowanMMolloy
bellletstalk america bellletstalk day	RowanMMolloy
dysthymicdad heard women suicide men bellletstalk	RowanMMolloy
song nice grammys	RowanMMolloy
mentalhealth community twitter kind loving retweetslove support forward bellletstalk day	RowanMMolloy
lionversusbear reaction partnersformentalhealth	RowanMMolloy
smoothie ready watch signofthree	RowanMMolloy
favourite thing aprojectforawesome stevethewall	RowanMMolloy
thought lost footage refilmed location halfhourlost	RowanMMolloy
finish btsov buttired findfoodthenwrite korbust	RowanMMolloy
smoke began speak hear head thumped eyes closed smoke moved nanowrimo	RowanMMolloy
rowan molloy left nanowrimo novel will win tomorrow will	RowanMMolloy
inukeyou kendramase thesprintshack nanowrimo	RowanMMolloy
frinightwrites business will working writeclub korbust	RowanMMolloy
whoa korbust nanowrimo neverexpectedthistohappen	RowanMMolloy
korbust word blacksmith yes nanowrimo homestretch	RowanMMolloy
csolisr nanowrimo hey days write wind korbust	RowanMMolloy
ericnentrup start reboot doctorwho	RowanMMolloy
ericnentrup joining days dances tests things time track nanowrimo	RowanMMolloy
hello met you lovely nanowrimo ohgodimightactuallywinohgod	RowanMMolloy
lot positive reason going nanowrimo imdonenow	RowanMMolloy
hey hey guys thing called writers block smacked face uhoh nanowrimo	RowanMMolloy
ppmusic coach recommend frank hammond years addiction sugar justasuggestion	RowanMMolloy
write half hour ohgod nanowrimo	RowanMMolloy
side nanowrimo knight	RowanMMolloy
nanowordsprints nanowrimo birthdays goal people party	RowanMMolloy
coreyvidal missing minutes stupid long tims thatsoundedreallycanadian	RowanMMolloy
nanowordsprints to deserved break imo nanowrimo	RowanMMolloy
goal pageschapter working moment nano nanowrimo gah	RowanMMolloy
nanowordsprints goal day	RowanMMolloy
school will write lunch alextwestlake is nanowrimo	RowanMMolloy
coreyvidal bufferfestival apprenticeeh ctfxc shaytards	RowanMMolloy
gmm good mythical morning hashtagwar	RowanMMolloy
rochester alextwestlake tsbnick ciarawigram	RowanMMolloy
mackavaldez tsbnick mysterious red light purpose tsbnickyear ohmygod	RowanMMolloy
tsbnick party time	RowanMMolloy
alextwestlake heyimissie aww	RowanMMolloy
things science teacher answered question guessitalktoofast tsbnick tsbnickyear	RowanMMolloy
tomorrow mondayisbadenough ihavelikesixthingsdue tsbnickyear	RowanMMolloy
will good year smktv tsbnickyear smktv	RowanMMolloy
tsbnick alextwestlake tweet itsamiracle tsbnickyear	RowanMMolloy
potions feels long missed great hall food hogwarts	RowanMMolloy
met alley purpose dark night crescent moon heads foundmymuse amwriting	RowanMMolloy
guess wrote novel yesterday thathappened campnanowrimo	RowanMMolloy
internet connection exceptsonga gettingdistracted	RowanMMolloy
conflict havingfunwritingagain thiswontendwell	RowanMMolloy
finally catching campnanowrimo goal steamingahead writingupastorm	RowanMMolloy
dftba darling fetch battle axe	RowanMMolloy
favorite foods rowan pizza	RowanMMolloy
tsbnick mental problems	RowanMMolloy
woo hoo voted win mybbb destinations ultimate rtw trip cash bryarly	RowanMMolloy
corradocoia guessing card lost mail enjoying tims card	RowanMMolloy
nanowordsprints sentence will writing jail	RowanMMolloy
coreyvidal blogtv tonight	RowanMMolloy
apprenticeeh feel totally awful watch coreyvidal video feel things will	RowanMMolloy
girls talking nutrition facts mcdonalds totally thought tyleroakley itsmcdonalds itsallfat	RowanMMolloy
omg gravity falls tyleroakley live	RowanMMolloy
corradocoia bowl soup xd	RowanMMolloy
coreyvidal good to aa sign shirt signed year ago fathers day	RowanMMolloy
nicolelandryy great hear happy decision success ahead	RyersonU
scssstg sweet tooth	RyersonU
congratulations ratnaomi ryersons gdxryerson senate appointment	RyersonU
friendly faces welcoming ryerson openhouse	RyersonU
zmfxo check whyryerson questions open house find mattamyac tomorrow	RyersonU
catch ryerson theatre schools third season holiday trilogy week	RyersonU
pleasure mayor visit campus	RyersonU
special guest lecture forbiddenroom director guy maddin tomorrow brought ryersonfcad	RyersonU
ryersons farrahkhan discusses media coverage sexual violence canada	RyersonU
double titles rams womens basketball team defeats ottawa win st oua championship werrams wearechamps	RyersonU
afraid big questions great advise robertabondar	RyersonU
college park barbara ann scott skating rink will construction rebuild park skating facility	RyersonU
explore fashion afterthought academics drbenbarry	RyersonU
three minute thesis mt challenge offers graduate students opportunity impact study	RyersonU
congratulations ms viola desmond bursary recipient susanne nyaga	RyersonU
excited climate hack action tackle climate change head april register	RyersonU
catch glimpse rslc morning cbcs disruptingdesign mattgallowaycbc	RyersonU
ryerson photo booth mattamyac strike best pose team photo omgrobots ryersonfrc	RyersonU
happening mattamyac today cheer future engineers omgrobots ryersonfrc	RyersonU
rslc won centerforarch honor award alongside exceptional designs	RyersonU
stephen leacock collegiate institute team running motions ahead ryersonfrc competition good luck	RyersonU
feb image arts building lit night help raise awareness homelessness torontostar	RyersonU
free bus oua finals support ryersonrams today day sign	RyersonU
live peelregion st generation immigrant participate shareyourjourney	RyersonU
littlelaur will continue monitor evening tomorrows schedule updates will posted	RyersonU
nicolegentles nabzay open monitor weather updates	RyersonU
question dean graduate studies tomorrow chance	RyersonU
board senate elections vote online feb mar pm	RyersonU
mindandaction organized ryerson tiffnet special guests including mayor johntory	RyersonU
check violadesmondaward winners	RyersonU
board senate elections candidate	RyersonU
knit drop digital media experience lab rslc monday knitting sessions starts	RyersonU
erinlmaloney hello reaching students will check exam schedule online march ryersonexams	RyersonU
apartment hunting attend offcampus housing fair tues march help search	RyersonU
session biomedicalzone tuesday lessons medtronicca	RyersonU
time oscars ryersons ryecomcultgpd offers predictions win share	RyersonU
jcappadocia classes going acceptance celebration congratulations	RyersonU
inadownpour travel safe	RyersonU
lauragirardo exercise safety travelling classes stay tuned weather schedule updates	RyersonU
scenes ryerson curling team	RyersonU
love floor reminds maze great place quiet study rslcyr	RyersonU
sixth annual queer black history gala takes place thursday ryerson student centre rsvp visit	RyersonU
ryerson university lifeline syria challenge helps refugee family start life canada	RyersonU
pylon trouble application reach whyryerson	RyersonU
oliviarossetti recommend checking directly programdepartment class schedule easter monday	RyersonU
changschooltalks allday coverage follow changtalks twitter	RyersonU
ryerson budget town hall meeting set february pm	RyersonU
grad students rsvp expert panel career pathways graduate success feb gradtalks lecture	RyersonU
ryerson alumni glenn pushelberg george yabu yabu pushelberg award innovation interior design	RyersonU
mbredeques dancanthinks we	RyersonU
successful business understand people nba hall famer wayne embry trsmryersonu mkt panel	RyersonU
february attend potluck campus honour missing murdered indigenous women men children	RyersonU
ryersons cukierwendy joins ecofcanada panel discussion syrian refugee resettlement friday rsvp	RyersonU
special puck drop norm helping ryerson raise funds ru osp	RyersonU
changschool changschooltalk interactive classes thoughtprovoking discussions wednesday	RyersonU
ryerson town hall meeting budget takes place tomorrow visit	RyersonU
grad students rsvp expert panel career pathways graduate success feb gradtalks lecture	RyersonU
nominated board senate election attend mandatory student candidates session feb pm jor	RyersonU
study sessions hangouts friends killing time classes rslc space	RyersonU
enjoy night poetry support daysdry check slammin style february	RyersonU
geminidesignz area campus encountered	RyersonU
interested development ryerson budget participate todays budget town hall	RyersonU
president lachemi premier wynne iuliana calin india exciting partnerships monday	RyersonU
issue sophmore created students alumni instructors ryersonfcad rcdsonline	RyersonU
mens womens basketball teams court tonight brock badgers werrams beatbrock	RyersonU
akua benjamin public lecture pay tribute years activism resistance toronto feb blackhistory	RyersonU
slc building share score free swag rslc	RyersonU
interested ryerson governance attend session board senate elections feb noon jor	RyersonU
amazing student nominate dennis mock student leadership award feb	RyersonU
grad students win winners grad word video contests revealed feb rsvp	RyersonU
students to brand business ryersonu designer residence offers advice ruzonelearning	RyersonU
ryersonrjrc welcomes trc commissioner cbc journalist marie wilson atkinson lecture feb	RyersonU
edition photobook collaborative effort ryerson photography students starts jan	RyersonU
meet entrepreneur residence ryan van wert talks ryerson today biomedical zone	RyersonU
interested ryerson governance attend session board senate elections feb noon jor	RyersonU
grad students win winners grad word video contests revealed feb rsvp	RyersonU
join huge game tonight mac ryerson rams womens hockey team takes rival york lions free onecard werrams	RyersonU
checked ryersons soapbox changes fun exciting things log myryersonca today	RyersonU
grad students win winners grad word video contests revealed feb rsvp	RyersonU
check immersive interactive exhibit ripple ryerson architecture students jan jan	RyersonU
ryerson image centre celebrates female artists three exhibitions opening week	RyersonU
opinion matters public realm open house hear share ideas evolving campus today	RyersonU
meet ryersoncareers campus engagement ambassadors working fellow students build careerrelated skills	RyersonU
attn students kick start years resolutions visit mattamyac jan help inspiration	RyersonU
george vari engineering building eng temporarily closed flooding burst water pipe eng	RyersonU
update ryersons presidential search onpse	RyersonU
university closed winter break reopening january enjoy time loved holiday season	RyersonU
video happy holidays ryerson university	RyersonU
join hot chocolate treats caroling jorgenson lobby dec santa stops	RyersonU
join hot chocolate treats caroling jorgenson lobby dec santa stops	RyersonU
saddened the news prof mark ernstings passing thoughts friends family	RyersonU
education technology consultant professor drtonybates appointed distinguished visiting professor changschool	RyersonU
days ryersonexams you hungry open rueats	RyersonU
gracelao read original blog post medias interpretation	RyersonU
academic advisement report ramss monitor academic progress ryerson	RyersonU
remember writing ryersonexams desk onecard pencils approved aidstools	RyersonU
stress small talk strangers prof martin antony talks ctvnews social anxiety holidays	RyersonU
exams full undergraduate calendar ryersonexams	RyersonU
confirm eligibility graduate officially graduated request letter ryerson	RyersonU
institute study csr hosts event indigenous consent canadian mining dec noon	RyersonU
ryersonfcs curld rescon host escalating challenge ownership costs risks dec	RyersonU
ryerson search vice president innovation onpse	RyersonU
starting monday eateries kiosks campus will operating preholiday hours check details	RyersonU
join panel violence women identify preventative solutions campus today pm	RyersonU
help hit unitedwayto goal year	RyersonU
ryerson community hold december memorial dec pm ryequity	RyersonU
join usetherightwords explore media coverage sexual violence tomorrow pm	RyersonU
congratulations joanne dallaire courage award futureaces amazing aces character awards	RyersonU
rejeanpinder apologies week early tweet	RyersonU
ryerson community hold december memorial dec pm ryequity	RyersonU
vbruce great work colleenfilson emma big fans dadjokes	RyersonU
rustudentlife video leash wonderful rutherapydogs program	RyersonU
givingtuesday help ryersonu students succeed	RyersonU
ryerson host speaker panel gun violence women nov pm ryequity	RyersonU
anniepoulin contacting media relations ryersondmz magnettoday	RyersonU
nocommentlaura soup cafeteria amazing trust	RyersonU
times good fail fail hard regroup move ryersonfashion mondaymotivation rumotivated	RyersonU
join share memories enjoy refreshments celebrate achievements president levy nov mac	RyersonU
built environment contribute wellbeing ryersons ryersondas	RyersonU
join share memories enjoy refreshments celebrate achievements president levy nov mac	RyersonU
application graduate spring convocation ramss ryerson	RyersonU
join share memories enjoy refreshments celebrate achievements president levy nov mac	RyersonU
idea maker space campus win attend briefing nov learn	RyersonU
cash prizes grad word second video contests enter dec win ryerson	RyersonU
object campus believed cow heart toronto police investigating update community	RyersonU
tonight pm carlton st untangling aftermath arab uprisings western policy responses	RyersonU
earlyyearserica start connect whyryerson	RyersonU
grad students join imagining canadas future video launch networking event nov rsvp	RyersonU
jack cockwell donates brookfield institute family ryerson	RyersonU
attend conversation centred ken greenbergs walking life lessons city builder nov	RyersonU
attend chillin gould today pm rain location slc main lobby unitedway ruunited ryerson	RyersonU
joined remembrance day ceremony	RyersonU
attend chillin gould nov pm support united ruunited	RyersonU
ryersondas prof vwhui developed experiential learning resources refine students skills classroom	RyersonU
icymi ryersondmz ranked leading universitybased incubator north america ubiglobal entrepreneurship	RyersonU
ease exam stress ryerson moves free minute yoga meditation classes nov slc takecareru	RyersonU
maple leaf gardens mattamyac grew torontostar	RyersonU
student campus centre oakham house closed today city water main break city crews site	RyersonU
weegee murder business ricgallery photography	RyersonU
ryersonsafety torontopolice hosting info table slc today pm talk crimepreventionweek	RyersonU
ricgallery exhibitions curator ga lle morel today free tour weegee murder business	RyersonU
rutvnews covers kickoff event annual ted rogers management conference march	RyersonU
apply letter permission plan courses college university ryerson	RyersonU
ryersonpsych prof colleen carney tips cope time change ryerson	RyersonU
ryersonsls hosting allnight study session student learning centre nov ryerson	RyersonU
math researcher pawel pralat models experiments provide insights social network structures evolve	RyersonU
ryerson global innovation challenge applications open nov create viable business ideas	RyersonU
ann cavoukian wearable tech tough sell enterprise itbusinessca	RyersonU
ryerson global innovation challenge applications open nov create viable business ideas	RyersonU
professor rachel dodds htmryerson students talk cubas changing tourism cbcfreshair 	RyersonU
catch octobers sustainability matters newsletter online rsustainability	RyersonU
join united cn tower climb help people move poverty possibility ruunited	RyersonU
toronto star cartographer discusses ryerson image centre exhibition ryerson	RyersonU
dimensional innovation fund inaugural recipients receive pursue printing	RyersonU
cur policy seminar oct ryersonfcs	RyersonU
ryersons emergency awareness preparedness response procedures visit	RyersonU
spoken word artist ryerson alumnus brianmillados inspiring weday message	RyersonU
ryersonjourn alum cbchereandnow producer ingwongward shares great career advice	RyersonU
rsvp learn ryersons urban development master program oct	RyersonU
rsvp learn ryersons urban development master program oct	RyersonU
attend fighting silence honduras battle corruption impunity violence tomorrow	RyersonU
attend fighting silence honduras battle corruption impunity violence oct	RyersonU
trsmryersonu survey finds canadians vote bc feel political system corrupt cdnpoli elxn	RyersonU
trsmryersonu survey finds canadians unsatisfied ethical behaviour political leaders cdnpoli elxn	RyersonU
explore public cultural performance ryersonfcads performigrations exhibit oct	RyersonU
obanewss basketball life career symposium high school girls takes place tomorrow mattamyac	RyersonU
attend oct learn advances tech ryerson researchers students great discount	RyersonU
attend oct open house learn master applied math ryerson	RyersonU
help support community donation united ruunited	RyersonU
place crash ryersons commuter hostel	RyersonU
good morning ryerson	RyersonU
ellen hibbard creates unique communication culture phd defence american sign language	RyersonU
happy thanksgiving reminder ryerson closed today holiday will reopen tuesday	RyersonU
explore public cultural performance ryersonfcads performigrations exhibit oct	RyersonU
attend mens hockey opener tomorrow ryerson werrams	RyersonU
ruservicehub watch video find onestop shop administrative	RyersonU
ryerson pride tomorrows rams season kickoff tailgate party	RyersonU
cast vote federal election ryerson student campus centre october	RyersonU
students demo yahoos yahoolivetext app today launchzoneru slc floor pm ryerson	RyersonU
ubercanada general manager ian black ryerson mba speaker series trsmryersonu	RyersonU
tomorrow victoria st bw gould gerrard will dedicated nelson mandela walk join ceremony pm	RyersonU
ryersons mentalhealth website unique cdnpse landscape info employees students	RyersonU
attend mindfest tomorrow mentalhealth workshops inspirational speakers	RyersonU
startup lessons ryersondmzbased student entrepreneur rahuel goel pheedloop	RyersonU
volunteers needed sign oct help ryerson host toronto charity homeless connect mattamyac	RyersonU
ramily help support community donating united ruunited	RyersonU
good morning ryerson	RyersonU
directed michael winterbottom oct hosted immigration settlement studies ma program	RyersonU
visit ryersonedi site learn ryerson proudly diverse intentionally inclusive	RyersonU
grad student writing guru mark award recipient developed specialized graduate writing groups	RyersonU
alumni weekend tbt ryersons st dance ryersonlibrary	RyersonU
prof dianefrancis migrants will ukraine theworldpost	RyersonU
visit human rights services website services resources ryersonedi	RyersonU
cdnarch helping spread word	RyersonU
soup substance blacklivesmatter equity social justice policing today noon pod	RyersonU
employee award nominations open nominate exceptional faculty staff member today ryerson ryersonhr	RyersonU
studentmoveto launches survey campaign better transit find help	RyersonU
headed ouf plan ahead dvp currently closed fall maintenance will reopen mon sept ryersonouf	RyersonU
attending ontariounifair dvp will closed weekend plan ahead ryerson	RyersonU
ryerson rises student learning centre rslc cdnarch	RyersonU
ram ram celebrate gould street party oct ruaw	RyersonU
interested entrepreneurship startup school passport innovation	RyersonU
top things didn career centre ryersoncareer ryerson	RyersonU
eat gain weight ryersons nextlaboratory investigates torontostar nutrition	RyersonU
happy day fall ramily	RyersonU
htmryerson marks worldtourismday evening celebration trsmryersonu	RyersonU
ryerson supports ideas classroom launchzoneru rusocialventure rufashionzone ryersondmz	RyersonU
interested entrepreneurship startup school passport innovation	RyersonU
mens womens soccer teams play weekend downsview park rmc queens werrams	RyersonU
ryerson offers free financial literacy course students sign rudebtfree	RyersonU
drbenbarry weighs diversity fall fashion campaigns fashionspot	RyersonU
ryerson check ryersontoday online email latest news updates university	RyersonU
ryerson learn help succeed year	RyersonU
reminder ryerson will conducting fall fire drills legislative requirement buildings week	RyersonU
happy wednesday ryerson gould st farmers market pm	RyersonU
ryerson filmmakers debut sleeping giant today tiff ryersonfcad	RyersonU
gradcafe gradspace open house place noon today gerrard st info	RyersonU
ryersonu doubles syrian refugee sponsorship goal support surges ryerson lifelinesyriaru	RyersonU
check sustainability matters newsletter featuring sustainability annual report rsustainability	RyersonU
join ryersonfolio open house learn contribute rsvp	RyersonU
sonicbooming offensive signs condoned ryersonu ryerson group report ryersonfixit	RyersonU
davidcommon offensive signs condoned ryersonu ryerson group report ryersonfixit	RyersonU
brinorris offensive signs condoned ryersonu ryerson group report ryersonfixit	RyersonU
joshharrower offensive signs condoned ryersonu ryerson group report ryersonfixit	RyersonU
applepiyah working remove offensive signs campus report location ryersonfixit	RyersonU
sighoh working remove offensive signs oncampus report location ryersonfixit	RyersonU
happy rosh hashanah celebrating shanatova	RyersonU
mythbustersto ontsciencectr ends tomorrow ryerson community member discount	RyersonU
attending tiff check record number films ryerson alumni set screen festival	RyersonU
marcokuo concert ryesu event contact issues	RyersonU
terraloire terra great question rutherapydogs	RyersonU
lunch rustudentlife breaks best places eat video spoiler rueats list	RyersonU
gogonchar ryesu hear wrist bands assigned	RyersonU
reminder ryerson will conducting fall fire drills legislative requirement buildings starting monday	RyersonU
gritty underbelly manhattan weegees images display ricgallery oct	RyersonU
interested hrs sweat sawdust mosesstructures timberfever designbuild challenge	RyersonU
incredible ryerson tiff	RyersonU
kymacke main store gould st popup shop atrium order online info	RyersonU
thx pres levy chancellor bloomberg visiting drop gould st booth win rucampusstore mindandaction	RyersonU
drbenbarry weighs diversity fall fashion campaigns fashionspot	RyersonU
prof ltrye answers journalism questions arising peegate poynter	RyersonU
follow hlv embarks challenging journey member womens basketball team ryerson	RyersonU
questions follow ruservicehub answers enrollment class schedules ryerson	RyersonU
attending todays poetry slam location changed lib ryerson	RyersonU
reminder parking lot churchdundas will limited spots sept development	RyersonU
feel reflects ryersons place intersection mindandaction learn	RyersonU
happening ryerson roadtoryerson	RyersonU
quad ryerson roadtoryerson guinnesschallenge	RyersonU
survey cciresearch university grads secure good wellpaying jobs graduation cdnpse jobs grads	RyersonU
bluejays markshapiro president ceo trsmryersonu prof cheri bradish predicts hell thrive ctvnews	RyersonU
program passport relaunched connect ru find rustudentlife	RyersonU
learn best barrierfree routes travel campus ryersonedi roadtoryerson	RyersonU
president levy moves ryerson deputy minister training colleges universities dec	RyersonU
live tv students join corner gould victoria monday bttoronto participants prizes giveaways	RyersonU
reminder khe khw will power pm sat aug will closed community ryerson	RyersonU
free tickets day oct staff students email rsvpeventsryersonca aug chance win	RyersonU
will sexuality matter time professors maria gurevich doreen fumia weigh nowtoronto	RyersonU
currency surcharges store travelers htmryerson prof gabor forgacs discusses paxnews tourism	RyersonU
steps receiving transfer credit visit ryerson	RyersonU
khe khw will power pm aug will closed community ryerson	RyersonU
professors maria gurevich doreen fumia discuss celebrity identity sexuality nowtoronto	RyersonU
learn continuing education ryerson attend changschools open house aug	RyersonU
bof ranks ryerson school fashion best fashion school canada pse	RyersonU
maayanziv ryersonmdm launchzoneru ryersondmz accessnowapp congrats success maayan	RyersonU
dodge bullet ryerson friends family specialdiscount tomorrow mythbustersto ontsciencectr	RyersonU
rtainla making networking good ryerson	RyersonU
designers ryerson student learning centre changing face architecture globeandmail	RyersonU
ryerson friends family special discounts coolgiveaways aug ontsciencectr mythbustersto	RyersonU
apply letter permission plan courses college university ryerson	RyersonU
touring green roof vari usatoday small patch began ryerson	RyersonU
image prof melanie dempseys reveals consumers brand image psychtoday	RyersonU
trsm eph buildings power pm will closed community ryerson	RyersonU
canada celebrates strong parapan mattamyac globeandmail ryerson	RyersonU
rcc pitman hall will power tonight pm will closed community	RyersonU
confirm eligibility graduate officially graduated request letter ryerson	RyersonU
ann cavoukian exec dir privacy big data institute comments webcam cybersecurity breach yahoocanada	RyersonU
apply letter permission plan courses college university ryerson	RyersonU
victoria lane pod will blocked tonight pm pm crane lift access jor pod library will	RyersonU
happy long weekend week	SallySan_x
tim hortons nutella croissant pretty disappointing will stick plain croissant	SallySan_x
watching second maze runner	SallySan_x
franstar tdcanada problems logging	SallySan_x
love skype ignored tweet tweet wks ago quick money great customer service sarcasm	SallySan_x
askhalifaxbank hey jp managed print statement address reply	SallySan_x
bloody cute rabbit animals bunnies cute	SallySan_x
real time bed	SallySan_x
christmas hit gym	SallySan_x
hair coloured nervous	SallySan_x
worst feeling coming long day remove bed	SallySan_x
ao white bread	SallySan_x
wonder rush things thinking	SallySan_x
weeks till leave leave job	SallySan_x
time bed work tomorrow	SallySan_x
ten days long weekend	SallySan_x
forgot expensive foundation	SallySan_x
royalmail quick reply	SallySan_x
tesco plz respond call number store disconnected love store open	SallySan_x
jealous going digidreamsfest weekend canadians will raving stuck miserable uk	SallySan_x
jumpers shorts topshop outfit bromborough saved bargain shopping fashion	SallySan_x
chatimeuk manchester heart attack died chatime wat great surprise glad finally	SallySan_x
months realized specsavers months worth lenses paid extra	SallySan_x
beautiful stuck work	SallySan_x
veryoutdoors lahaciendauk chicken wings	SallySan_x
yahoomoviesuk diving yahoothestath thankyou	SallySan_x
nb better lol	SallySan_x
greedy hoping work provide free lunch today	SallySan_x
justeatuk firebox walking dead	SallySan_x
mcdonalds feel absolutely awful	SallySan_x
davelackie ninawmakeup beautiful palette love colours	SallySan_x
start shopping office wear	SallySan_x
happy chinese year	SallySan_x
happy pancake day	SallySan_x
urge shopping spree feeling long time	SallySan_x
revising microsoft assessment	SallySan_x
love testing products boots	SallySan_x
will watching episode walking dead tonight happy happy	SallySan_x
nb good hows job going	SallySan_x
hope gb accepts college application	SallySan_x
win beautiful dior set	SallySan_x
book hope good reading bedtimestory	SallySan_x
calvin harris snapchats random	SallySan_x
win ladies rose gold plated michael kors watch model mk worth sprinkleprizes sprinklecom	SallySan_x
mailonline french judge bans parents naming daughter nutella jeremitsme	SallySan_x
win amazon voucher sprinkleprizes sprinklecom	SallySan_x
win anna sui cheek nail gloss lipstick set	SallySan_x
dailymail mailonline femail idiots	SallySan_x
bedtime night night	SallySan_x
eating bed will learn	SallySan_x
gbcollege submit international student application asap guaranteed place course	SallySan_x
jeremitsme bonjour va	SallySan_x
selenagomez heart repeat	SallySan_x
liverpoolone start shopping octobernovember avoid disappointment deals debenhams shoppinghabits	SallySan_x
wait toofaced chocolate palette hit shelves uk	SallySan_x
gbcollege uk call understand letting select uk england citizenship	SallySan_x
quiche taste good	SallySan_x
dior black friday special giveaway	SallySan_x
nb long interview	SallySan_x
nb prepare interview early today ended turning alarm going bed	SallySan_x
to clothesshow birmingham buy pair tickets	SallySan_x
debenhamsbeauty time promotion tomorrow	SallySan_x
twitter telling notification	SallySan_x
seriously log netflix	SallySan_x
narsissist face primer	SallySan_x
nb hahahahahaha imagine fringe	SallySan_x
happy day today	SallySan_x
motivation today everyday	SallySan_x
nb time buy dad parked waiting will good	SallySan_x
nb hahahah lazy finish job application lol	SallySan_x
hongbinss phone internet package	SallySan_x
hongbinss talk talk good	SallySan_x
hongbinss jen nice eyes eyes fine	SallySan_x
hate filling applications	SallySan_x
nb visas released january february snatched quick better apply lol	SallySan_x
nb will arrange christmas time	SallySan_x
fancy pub meal forever lonely	SallySan_x
tired start day	SallySan_x
nb accidentally poked eyes prescription	SallySan_x
palettes urbandecaycosmetics toofaced nars smashbox	SallySan_x
dominosuk greville street dominosdash	SallySan_x
ordered nano sim combi sim frustrating going frigging mobile number	SallySan_x
nb posts months	SallySan_x
start diet today ended eating pizza hot dogs bit	SallySan_x
nb time lol good	SallySan_x
porter robinson ages kool haus seriously kids rave	SallySan_x
close deported twas scary	SallySan_x
downloaded tiestosclub album best purchase	SallySan_x
huge fan tiesto listening edc set soundcloudi completely blown	SallySan_x
takes baby grow shelves covered penis drawings mailonline	SallySan_x
spiritspure gin raspberry vodka blue cura ao lime juice simple syrup	SallySan_x
nb sallysan instagram	SallySan_x
nb schedule hard genuine people met toronto	SallySan_x
nb usual help	SallySan_x
digital dreams saturday	SallySan_x
digidreamsfest eaton centre watchin england game wen notification running yd missed england goal	SallySan_x
omg hard hold george brown phone	SallySan_x
nb nude person better wait	SallySan_x
nb air good months	SallySan_x
nb errrrrr display picture	SallySan_x
tan legs toronto bluejays lawrie iloveto	SallySan_x
napped hours yesterday surprisingly slept baby night	SallySan_x
walkerscrisps walkers change bbq flavour bbq ribs original bbq better	SallySan_x
nb time checked living sluts hole lane confirm true	SallySan_x
nb face angel	SallySan_x
nb will august september wanna	SallySan_x
nb dear good skype busy	SallySan_x
nb feel guilty	SallySan_x
nb tbh tht suck friend tho bailed times telling	SallySan_x
nb hard text friend brush bad	SallySan_x
chatimeuk guessing chatime stores uk	SallySan_x
living toronto years shopping liverpoolone scousers britishandproud	SallySan_x
nb hve job good bed dying vodka coke	SallySan_x
regret armin tickets metro	SallySan_x
nb will skype week fun	SallySan_x
nb omg awake forgot	SallySan_x
nb omg jeremy phone awful downloading apps	SallySan_x
nb surprises lol xx	SallySan_x
nb yeah grin bear	SallySan_x
nb drink night fucked time left canadians rave	SallySan_x
sad people respect	SallySan_x
weeks till raving guv	SallySan_x
chatime best bubbletea	SallySan_x
nb drivers license passport	SallySan_x
stupid tickly cough	SallySan_x
nb wait watch movies place buy lots snacks british snacks	SallySan_x
shift completed closing tomorrow	SallySan_x
nb dinner plans	SallySan_x
going night theguvernment sunday excited word rave party	SallySan_x
nb damn forgot sad	SallySan_x
craving thai curry	SallySan_x
martin garrix tonight	SallySan_x
veldfest will tickets sale	SallySan_x
jessicasanx tgi photos making hungry chicken wings good	SallySan_x
jeremitsme sad night sweetie	SallySan_x
pinkystoronto mtcc truck	SallySan_x
accidentally clicking follow awkward	SallySan_x
early start planning summer outfit digital dreams veld rave edm	SallySan_x
summer digital dreams festival	SallySan_x
thai express today best suddenly huge craving	SallySan_x
work tomorrow horrayyyy	SallySan_x
mailonline strange heard toronto	SallySan_x
nb foundation quick find cheap works good rimmel days ago bad	SallySan_x
nb yeah movies netflix canada start walking dead	SallySan_x
nb dog belong	SallySan_x
working nye nyd working service industry	SallySan_x
happy boxing day hope picked good sales didntcame empty handed eatoncentre	SallySan_x
watched supernatural jensenackles season	SallySan_x
pick language hard french	SallySan_x
nb problem immature retirement stage lol	SallySan_x
asos completely ruined day sending wrong dress size	SallySan_x
nb happy birthday	SallySan_x
god supernatural netflixca	SallySan_x
hongbinss loan worry	SallySan_x
nb snow will blizzard lol bad memory	SallySan_x
watching videos digital dreams soooo year	SallySan_x
omg wait hands urbandecay naked palette	SallySan_x
nb sleep late	SallySan_x
nb joy working kids brought upto hate humans lol	SallySan_x
nb surprised woodlands teach chinese kids offense her cantonese standard	SallySan_x
nb cantonese good better annes annes cantonese poor help	SallySan_x
nb the better face	SallySan_x
love netflixca breakingbad thewalkingdead	SallySan_x
yyifans buy gb cellular data will regret	SallySan_x
understand travel insurance	SallySan_x
nasima inviting steph she invited messaged facebook ago	SallySan_x
nasima hows diet going	SallySan_x
cooking vegetarian pad thai	SallySan_x
years laptop broken piece yyifans	SallySan_x
dimitrivegas omg missing	SallySan_x
nasima told will wrking hrs week wrking wrking hrs wk hw afford job	SallySan_x
jessicasanx watch walking dead online finished season watch season	SallySan_x
natashaanthea september will stay toronto till october	SallySan_x
shopping ebay td credit card	SallySan_x
love work britishairways	SallySan_x
person stressed abt trig equations identities spring break	shawnaoh_
ya will hot years working minimum wage job	shawnaoh_
people care environment ugh sigh	shawnaoh_
energy care stuff	shawnaoh_
heaveningano cutest thing	shawnaoh_
tannerallenn updated verson	shawnaoh_
wishing halsey tonight nope	shawnaoh_
megan foster megsn	shawnaoh_
orange hue filter snapchat cute	shawnaoh_
megan foster reverse racism exist	shawnaoh_
shit man pho	shawnaoh_
bio will death	shawnaoh_
time sunset insta shizaali	shawnaoh_
fuck post concert depression	shawnaoh_
happy birthday bestest friend best daddy	shawnaoh_
wanna will math final	shawnaoh_
wantneed olive garden	shawnaoh_
semester fucking sucks	shawnaoh_
klondike ice cream sandwiches	shawnaoh_
twerkling fuck twitter twat	shawnaoh_
grandma will favourite person	shawnaoh_
sarajangster lot coming twitter dp queen	shawnaoh_
twerkling jealous bc raunchy ass emo queen relatable	shawnaoh_
jayleenaustria sad cute sad	shawnaoh_
watching dolphin tale nye	shawnaoh_
happy birthday annoying bitch planet tienes os	shawnaoh_
glad exist existed closer	shawnaoh_
wait christmas music radio	shawnaoh_
thing school day fact masterchef junior starts today	shawnaoh_
megan foster tru	shawnaoh_
sushitown pm best time sushitown	shawnaoh_
allybrinn ayy ally	shawnaoh_
mariahhauser picture rvujcks sthank ilysm	shawnaoh_
chemistry making cry	shawnaoh_
oliviashannnon katie trash	shawnaoh_
shizaali diggin grave	shawnaoh_
mom making mashed potatoes	shawnaoh_
oliviashannnon uh olive	shawnaoh_
sarajangster happy birthday lovely hope day amazing love lots	shawnaoh_
twerkling thx bomb broseph xp luv ya	shawnaoh_
kimberlyyfaye twerkling owe guys	shawnaoh_
cried harder tfois	shawnaoh_
hombosexuals ahhh love	shawnaoh_
picking nose class	shawnaoh_
happy birthday love kaileyhbu	shawnaoh_
grade good year	shawnaoh_
kaileyhbu fun cute aw	shawnaoh_
sum deliver shamrock shake	shawnaoh_
dad dinner table wifi room sucks ass	shawnaoh_
aquarium favourite place entire planet	shawnaoh_
rip fatburger virginity	shawnaoh_
fattyofcakes fucking srs rn	shawnaoh_
jaeinjeong realize terrible	shawnaoh_
lorijiang justin bieber lovers club reunite	shawnaoh_
thousandth time losing jaein store today fml	shawnaoh_
fattyofcakes illegally drive places	shawnaoh_
terrifying life determined	shawnaoh_
maciverjenna lov bio	shawnaoh_
hear sos live	shawnaoh_
kimberlyyfaye luv ittt	shawnaoh_
andrekim happy birthday love youuu	shawnaoh_
mariahhauser stayed sobbing bb	shawnaoh_
vancouver sos live	shawnaoh_
jamalabc call ghetto	shawnaoh_
fattyofcakes bulky bb	shawnaoh_
fattyofcakes heard fans buy shawna mcdonalds	shawnaoh_
goddessofdork happy birthday leslie lauren lots	shawnaoh_
fattyofcakes meant american horror story thing lol	shawnaoh_
remembers malcolm middle	shawnaoh_
sarajangster bad bananas ice cream	shawnaoh_
michael sos basically pubes match hair	shawnaoh_
sleep saturdays volunteer	shawnaoh_
tanner ordering pizza sara shawna wheezing	shawnaoh_
kaileyhbu kailey mclennan	shawnaoh_
hombosexuals fuck acne day	shawnaoh_
foster people sex	shawnaoh_
sleep hours ooooooo	shawnaoh_
maciverjenna ready presentation going perf perf	shawnaoh_
joanneoh hear footsteps coco barking terrified nicole bacon	shawnaoh_
ashton sos stayed normal people ash sosfollowme	shawnaoh_
bet ms mccargars mom daughters outfit choices	shawnaoh_
chasegoehringtoplaylist hey love works	shawnaoh_
yeni restaurant wifi	shawnaoh_
sos to vancouver	shawnaoh_
worse volleyball year	shawnaoh_
calum love lots sos live	shawnaoh_
kaileyhbu rly wished lived lived rn	shawnaoh_
grade feel zombie god	shawnaoh_
luke sos vancouver vancouver vancouver	shawnaoh_
michael sos hair ocean	shawnaoh_
rickypdillon follow spamming social network site link cake farts ily	shawnaoh_
sos michael sos michaels hair ocean	shawnaoh_
briannejoe brianne bby youuu everyones fav	shawnaoh_
calum sos voice absolutely unreal	shawnaoh_
fucking fianc leaving fucking baby floor	shawnaoh_
lol failed quiz year	shawnaoh_
literally sims fucking long create fantasy life fast problem	shawnaoh_
watching timothy school party joannes party lol life	shawnaoh_
luke sos sleep man	shawnaoh_
sarajangster hows socials dying	shawnaoh_
waking cramp explains great day will	shawnaoh_
sarajangster excuse u	shawnaoh_
loneliness worst calllllll	shawnaoh_
jaeinjeong english stuff	shawnaoh_
literally science stupidest thing	shawnaoh_
hours bag corn chips homework	shawnaoh_
guy white boy swag listening ghetto rap black bb	shawnaoh_
going cry dear john	shawnaoh_
love shawna chaseyourwords live	shawnaoh_
fuck factor couple cute god	shawnaoh_
lol omg sos live	shawnaoh_
moodlight inthetubwith sos sos live	shawnaoh_
hombosexuals aw good	shawnaoh_
jamesyourwords omfg ahh	shawnaoh_
chrisyourwords guys adorable	shawnaoh_
woke chrisyourwords alexyourwords yooou	shawnaoh_
carly pretty aw chrisyourwords live	shawnaoh_
ashton sos rescue school	shawnaoh_
calum sos deepemotweets	shawnaoh_
album perfection ps amieisfierce	shawnaoh_
calum sos andysamuels aw bby	shawnaoh_
eat poo whatsupalicia	shawnaoh_
ashton sos lived la	shawnaoh_
carrots left mouldy sloth ball	shawnaoh_
jaeinjeong wonder ice cream thing	shawnaoh_
flashback hours ago	shawnaoh_
michael sos bed bby earlyyyy	shawnaoh_
calum sos pleaasee	shawnaoh_
boys happy sos	shawnaoh_
ashton sos ashton will selfie pillow	shawnaoh_
jennamaciver bish voss water	shawnaoh_
butt numb hate vancouver	shawnaoh_
ashton sos ashton irwin biggest cutie	shawnaoh_
ashton sos shot butt feel sick bby	shawnaoh_
andrew belle enemy itunes	shawnaoh_
hombosexuals calums face onion	shawnaoh_
fahmiejdemoura dm calum follow omg love	shawnaoh_
cjakn kof ei dkkjr skkahe skqpeo dad roaming hallways pretending type essay shit omg lol ok	shawnaoh_
luke sos lukeyyy	shawnaoh_
you calum rugged sosanswerme sos live	shawnaoh_
follow unlimited supplies pizza sosanswerme	shawnaoh_
trend moist calums sake sosanswerme	shawnaoh_
babies omg sos live	shawnaoh_
luke sos rocks luke hemmings	shawnaoh_
hombosexuals reminded bad	shawnaoh_
sos swag points ashton michael	shawnaoh_
calum sos taste rainbow real good	shawnaoh_
idek rn holy	shawnaoh_
calum sos notice life perfect sack shit	shawnaoh_
calums actual tattoo guys calum sos	shawnaoh_
sos time tbh	shawnaoh_
hombosexuals sharks clitorises lose	shawnaoh_
white people withdrawal jennamaciver	shawnaoh_
tea grease aw jennamaciver	shawnaoh_
aw parents bby	shawnaoh_
jennamaciver literally hate	shawnaoh_
niallofficial fuck muscles	shawnaoh_
jennamaciver dies working	shawnaoh_
sos wow aw rip	shawnaoh_
calum sos follow spree	shawnaoh_
hollaclare hahahaha jesus pray haunted nasty ass demons amen	shawnaoh_
calum sos beer	shawnaoh_
baconiam omg nice holy shit god night omg idek	shawnaoh_
baconiam please calum follow	shawnaoh_
hombosexuals aw bby	shawnaoh_
hombosexuals hahah work maintain enjoy thought	shawnaoh_
calum sos calum hoodrat	shawnaoh_
christina perri love	shawnaoh_
jaeinjeong holy cannoli remember aw bfflz	shawnaoh_
jaeinjeong week tbh bc familys going stay friends	shawnaoh_
jaeinjeong kristinnitara playland week sunday pls	shawnaoh_
calum sos finding youtube covers best thing life	shawnaoh_
calum sos luke sos legskinban marry	shawnaoh_
kimberlyyfaye mariahhauser rly dark picture tan tbh	shawnaoh_
hombosexuals lauren clifford tbh	shawnaoh_
luke sos vancouver	shawnaoh_
calum sos wow meant	shawnaoh_
honestly left forward	shawnaoh_
luke sos fucking god guys perfect bought shirt bc told aw ily	shawnaoh_
jaeinjeong imagine meeting big bang	shawnaoh_
shawna signed yoga whaaat	shawnaoh_
help concentrate direction days	shawnaoh_
calum sos love meeeeeee	shawnaoh_
ya grade orientation	shawnaoh_
shit intestines jumping days	shawnaoh_
short hair girls yeah short dicks guys	shawnaoh_
sosfamilyfolllowspree follow buy food	shawnaoh_
montsedeveras scotch egg	shawnaoh_
jenevabors going direction bc flawless face bye ily	shawnaoh_
keviniskiho text bc twitterverse hates	shawnaoh_
jaeinjeong ihop kristinnitara	shawnaoh_
bachadam hair salon	shawnaoh_
twerkling going question	shawnaoh_
realize direction month	shawnaoh_
love stupid tweets	shawnaoh_
tanner anna hot steamy sex washroom kinky	shawnaoh_
help father sitting	shawnaoh_
walking ghetto midnight safe niallonnylon	shawnaoh_
ddlovato album fab listening ok	shawnaoh_
good night bee missing	shawnaoh_
direction ilysm ok	shawnaoh_
jaeinjeong course bby	shawnaoh_
niallonnylon twerkling ideaz	shawnaoh_
bachadam aw sucking dick guess	shawnaoh_
twerkling direction faggot	shawnaoh_
rachelmetznr aw thing cookies cream icecrem freezer ha	shawnaoh_
notice tied hair maciverjenna	shawnaoh_
anitakerster jakeseed kimberlyyfaye lesion porn	shawnaoh_
niallonnylon worse thomas parker	shawnaoh_
ew school exist	shawnaoh_
kmichaela jaeinjeong ya heard jaein	shawnaoh_
girls body hair	shawnaoh_
twerkling tanner stahp	shawnaoh_
ugh spoby sex lana pll perfection	shawnaoh_
cry asap omfg	shawnaoh_
doubledazzle jennamaciver fault stars movie omfg happen begging knees pray tonight	shawnaoh_
ugh tests ughghhghggh die em eff geeee	shawnaoh_
wear converse dress kaileyhbu	shawnaoh_
kyliejenner good butt joanne	shawnaoh_
timesaday christian tho lol whoops	shawnaoh_
jennamaciver waaaah waaaah waaaah waaaah waaaaaaahahahahaaaaa	shawnaoh_
danniprasad jennamaciver guys thankful	shawnaoh_
net income month pay checks going straight visa bill	Simon_Pella
bernie lot strong	Simon_Pella
episode glad family learned lot blackish	Simon_Pella
tidalhifi best thing payed years exclusive content nickiminaj buy	Simon_Pella
wanted win relax	Simon_Pella
greaselive sooo good amazing work	Simon_Pella
white ppl afraid called racistincluding called defensive	Simon_Pella
tonight school night foreign ryerson students	Simon_Pella
girl break playing piano hospital lobby good nice calm morning	Simon_Pella
nehaaas good luck lady	Simon_Pella
reputation glass water throw and spreadsi love maura	Simon_Pella
agree word focus tweet not cheers	Simon_Pella
feel absolutely sick stomach tonights attacks imaging france going paris	Simon_Pella
ashoke king lol	Simon_Pella
nights scandal time episode ends fck	Simon_Pella
kids library screaming laughing stupid kids heart stopped good seconds	Simon_Pella
um delete herecomesastorm	Simon_Pella
ydkm tweeted serious going jump bridge	Simon_Pella
hunny paraamiobenoic acid sunburnchemistrythingsz	Simon_Pella
hotlineting famous tweet favs	Simon_Pella
tracy ellis ross favourite tweet	Simon_Pella
hotlineting congrats maeve	Simon_Pella
holdenmirror carlyfiorina concerned lying american republican political analysts	Simon_Pella
literally saved bell	Simon_Pella
wait till hockey starts	Simon_Pella
jake kraft dinner wtf	Simon_Pella
money sponsor refugee syriacrisis	Simon_Pella
nickiminaj second thought pregnant	Simon_Pella
happy birthday fan ydkm ps change tiwtter birthday girl will kill	Simon_Pella
priyankachopra soooooo beautiful	Simon_Pella
going jays fan winning bandwagon	Simon_Pella
lilzonii nat love	Simon_Pella
antidote good song ydkm ityou tbh	Simon_Pella
ydkm apology heaven	Simon_Pella
suppaaaa hot nickiminaj banger	Simon_Pella
police cam footage samdubose wtf	Simon_Pella
nickiminaj summer second walked stage	Simon_Pella
burden talk seconds smh subtweetcentral	Simon_Pella
breast peace vine valiumvillage	Simon_Pella
love politics vine moi	Simon_Pella
hunny good picture dead vine peteblackburn	Simon_Pella
nickiminaj wanna send invite dm	Simon_Pella
bless dad copping job	Simon_Pella
liesivetoldmyparents mom itunes payments bills thought apps free	Simon_Pella
ih tvvitterhoes lilzonii troll	Simon_Pella
fucking crying vine leethe	Simon_Pella
vine giraffe edits	Simon_Pella
mom crashes party imjakepaul georgejanko vine loganpaul	Simon_Pella
guy concerts vine kindasarahx	Simon_Pella
knew chick gonna the start vine thugrockstar	Simon_Pella
gun ib masonchillout rayrod meekmill hoodaf vine rayrod	Simon_Pella
telling beautiful women	Simon_Pella
ohhhh cutting soul	Simon_Pella
killed history presentation barely going wound french	Simon_Pella
nickiminaj video honestly dead	Simon_Pella
kerrywashington scandafinale aleady killing	Simon_Pella
toronto dudes prepared confrontation vine therealskitzz	Simon_Pella
shots lol cookiemonster remake drunk tgif vodka twoshotsofvodka twoshots vine ilovebtv	Simon_Pella
friend chill kingbach evanabikzer sneakingshots vine pagekennedy	Simon_Pella
library hood shhh jasonmendezhoe forya vine jasonmendezhoe	Simon_Pella
lied favourite song nickiminaj pinkprint	Simon_Pella
bae play aint mood vine wade	Simon_Pella
nickiminaj bring omg logoutyourphone	Simon_Pella
aint happy bout	Simon_Pella
hotel tv work pretty convo front desk vine jusreign	Simon_Pella
ilhamdirie happy birthday bismullah	Simon_Pella
thug life wrong nate fields ayetwinz	Simon_Pella
tweeters gonna tweet	Simon_Pella
srxo daniel natalia lily mariah wendys	Simon_Pella
thepussyasylum game jit	Simon_Pella
eaten lovelife iloveflowweek	Simon_Pella
nickiminaj lethal lyricist mc mogul	Simon_Pella
nickiminaj rap logoutyaphone	Simon_Pella
jusreign vines pee	Simon_Pella
melarmata thekaitlynmini classic	Simon_Pella
nickiminaj album grand piano lied thepinkprint	Simon_Pella
nickiminaj trini dem girls best video coughs coughs	Simon_Pella
nickiminaj grand piano shanghai trini dem gyals fire hot thepinkprint	Simon_Pella
nehaaas today fun india	Simon_Pella
roads literally ice	Simon_Pella
girl holding music vine	Simon_Pella
waiting thepinkprintcover nickiminaj	Simon_Pella
emo version girls vine	Simon_Pella
people handle tv interviews differently max jr jerry purpdrank vine	Simon_Pella
school nurses ft jasonmendezhoe ib pagekennedy rllyngga vineapp	Simon_Pella
happy rosh hashanah celebrating today	Simon_Pella
cursive game point	Simon_Pella
unexpected jenan wesley lam vineapp	Simon_Pella
love phone dies cord charge lost lovelife	Simon_Pella
night queen size bed byeflorida hellocanada	Simon_Pella
holocaust museum moving learned lot	Simon_Pella
kid guilts stuff vineapp	Simon_Pella
sentence essay amir morals spout sprang poet	Simon_Pella
srxo storyofmylife free saturday	Simon_Pella
ghetto girls summer school ep vineapp	Simon_Pella
blow ear babe yung poppy possibleremake jessicavanessa ratchet	Simon_Pella
born highway accidents happen	Simon_Pella
nehaaas exactly thinking bout	Simon_Pella
aint yelling cut shooting time sign recruiting time chiraq	Simon_Pella
summergemmell time breakfast	Simon_Pella
nickiminaj gunna turn car poolers car pillsnpotions	Simon_Pella
dogs promise chase	Simon_Pella
mrhail left sign turns today opposite day nawww	Simon_Pella
math test going blesssed feelinggoodcauseistudied	Simon_Pella
katieqlowes thing scandalfinale	Simon_Pella
save girls school	Simon_Pella
hell girl birthday thekaitlynmini crazygifts	Simon_Pella
woman movie theotherwoman	Simon_Pella
big news band life onerepublic	Simon_Pella
beybrazilian beyooooooooooonc chegooooooooooou beyonceatgrammys lolllolol simonasantagato	Simon_Pella
repeat stuff repeat stuff repeat stuff	Simon_Pella
spoke deaf customers todaygreat shift	Simon_Pella
white fudge covered double oreos	Simon_Pella
awe kind feel bad robford lost respect admitted	Simon_Pella
phone worth keeping phonebloks	Simon_Pella
finished mi homewurk	Simon_Pella
people favourite tweets creepy	Simon_Pella
plot twist spiderman jail	Simon_Pella
app kasie hain	Simon_Pella
cosplaying hobbit tomorrow fanexpo	Simon_Pella
jadenovah song amazing sound beyonce	Simon_Pella
thought person named larry shippers died	Simon_Pella
finished reading helpin days good favorite book	Simon_Pella
salt air dumped truck salt throat expected breath	Simon_Pella
years going people perfum bottles city fun hell nickiminaj	Simon_Pella
lot respect acehood	Simon_Pella
woke bugatii jks woke grandmas	Simon_Pella
thepussyasylum tweeryourfriendshipinapicture exposed	Simon_Pella
faerie caves ii neopets game nostalgia felt game	Simon_Pella
nickiminaj trending toronto performances awesome	Simon_Pella
white moms black moms pt dontjudgeme funny damn fuckit angry trick vine seenive	Simon_Pella
realmissutusa watched jimmykimmel great sense humor	Simon_Pella
heard stairs showering leaving bathroom	Simon_Pella
studying tanning sorrynotsorry	Simon_Pella
scary noises night scare scared scary	Simon_Pella
nickiminaj listen school	Simon_Pella
tosses salad literally	Simon_Pella
will power takes start culminating days alot stayingstrong	Simon_Pella
nose bleed day will homework	Simon_Pella
shushawnaa late school	Simon_Pella
congrats ailishpella completing torontohalfmarathon	Simon_Pella
fell stairs times day better days	Simon_Pella
baby chameleons cuted	Simon_Pella
casually listening candiceai day	Simon_Pella
nickiminaj um cananybodyhearme favorite song song soooooooo good	Simon_Pella
tbt pictures years ago supposed disgusting picture puberty braces style acne	Simon_Pella
deaf people signing sly station life complete	Simon_Pella
heart attack you start smell burnt toast	Simon_Pella
lohanthony caught slippin	Simon_Pella
jordankmills kidding sweetie	Simon_Pella
thekaitlynmini melarmata hang hose tomorrow game	Simon_Pella
lindsaychrist thepussyasylum songs introduced	Simon_Pella
heywhyd twicecuz thought hello faces	Simon_Pella
black friend racist black friends kevin hart lmfao	Simon_Pella
asked wanted caption picture best nonni cute	Simon_Pella
eating raspberries cup classy	Simon_Pella
hours straight slowly losing body control	Simon_Pella
busy week jesuz	Simon_Pella
hate cold tired	Simon_Pella
lost start wearing runners school lazy	Simon_Pella
hashtag cats cats	Simon_Pella
finish watching droz feel disease	Simon_Pella
iisuperwomanii to bathroom watching good idea cleaning	Simon_Pella
nice st birthday dinner nonni grandpa lovethem	Simon_Pella
kick balls del units pain birth kids breaking bones time	Simon_Pella
today bad day regretful	Simon_Pella
plying monster game nickiminaj	Simon_Pella
ms shafiq bathroom christina guy girl meet	Simon_Pella
funniest thing evr watched	Simon_Pella
mywishin active moving everyday	Simon_Pella
nomore gangnam style	Simon_Pella
prayfornewton poor children mother fucking children dead	Simon_Pella
happy hanukkah jews	Simon_Pella
mon visage burning	Simon_Pella
birthday swag nehasati shushawnaa golfwanghoe	Simon_Pella
going birthday shopping today tonsoffriends	Simon_Pella
worst english class boringashell	Simon_Pella
beat daniel hard fault annoying wtf	Simon_Pella
shushawnaa profile pic deep	Simon_Pella
bonita humber lakeshorefashion fashionblogger streetstyle toronto style	styleofthesix
supastarjo uhhh halifax	tanya_babbar
